año,mes,nación,5 estrellas,4 estrellas,3 estrellas,1 y 2 estrellas,hoteles,extrahoteleros,total
2006,1,España,3031,9561,1840,21,14453,1750,16203
2006,1,Holanda,235,2215,943,46,3439,2346,5785
2006,1,Bélgica,723,3421,836,15,4995,895,5890
2006,1,Alemania,1344,13711,4467,53,19575,4387,23962
2006,1,Francia,191,1162,282,79,1714,1195,2909
2006,1,Gran Bretaña,4025,17402,7114,636,29177,27398,56575
2006,1,Irlanda,85,105,1,5,196,629,825
2006,1,Italia,164,5550,495,5,6214,1471,7685
2006,1,Suecia,120,2882,637,0,3639,4494,8133
2006,1,Noruega,115,604,783,1,1503,1793,3296
2006,1,Dinamarca,52,860,1057,977,2946,2534,5480
2006,1,Finlandia,64,628,479,18,1189,3758,4947
2006,1,Suiza,154,385,100,10,649,155,804
2006,1,Austria,80,674,100,5,859,248,1107
2006,1,Rusia,276,810,267,56,1409,1659,3068
2006,1,Países del Este,328,499,257,8,1092,944,2036
2006,1,Resto de Europa,139,611,742,8,1500,960,2460
2006,1,Estados Unidos,71,62,13,5,151,228,379
2006,1,Resto de América,45,40,26,10,121,18,139
2006,1,Resto del Mundo,307,452,94,0,853,132,985
2006,2,España,2772,8558,2123,44,13497,2742,16239
2006,2,Holanda,538,2123,914,0,3575,2705,6280
2006,2,Bélgica,780,3373,552,30,4735,798,5533
2006,2,Alemania,2400,13243,4339,56,20038,4092,24130
2006,2,Francia,428,1285,395,91,2199,2021,4220
2006,2,Gran Bretaña,5127,17149,6544,616,29436,29969,59405
2006,2,Irlanda,236,99,49,0,384,594,978
2006,2,Italia,243,3635,380,3,4261,1128,5389
2006,2,Suecia,177,2150,538,0,2865,3141,6006
2006,2,Noruega,128,706,716,5,1555,1592,3147
2006,2,Dinamarca,106,1024,1331,841,3302,2280,5582
2006,2,Finlandia,54,736,435,0,1225,3573,4798
2006,2,Suiza,97,299,75,8,479,132,611
2006,2,Austria,225,581,86,8,900,299,1199
2006,2,Rusia,106,417,278,25,826,1090,1916
2006,2,Países del Este,259,303,202,10,774,800,1574
2006,2,Resto de Europa,127,533,656,5,1321,657,1978
2006,2,Estados Unidos,49,76,12,0,137,663,800
2006,2,Resto de América,31,63,3,10,107,67,174
2006,2,Resto del Mundo,494,69,126,0,689,97,786
2006,3,España,3408,11024,1850,41,16323,2431,18754
2006,3,Holanda,474,2406,719,0,3599,2353,5952
2006,3,Bélgica,832,3399,485,23,4739,794,5533
2006,3,Alemania,2689,15872,4597,81,23239,4080,27319
2006,3,Francia,377,1096,471,36,1980,1501,3481
2006,3,Gran Bretaña,5029,19632,7412,707,32780,37048,69828
2006,3,Irlanda,181,81,18,0,280,633,913
2006,3,Italia,197,2964,331,5,3497,774,4271
2006,3,Suecia,141,2893,584,0,3618,3201,6819
2006,3,Noruega,69,577,478,0,1124,1729,2853
2006,3,Dinamarca,141,1022,1114,806,3083,2525,5608
2006,3,Finlandia,46,820,564,5,1435,3698,5133
2006,3,Suiza,171,443,90,10,714,85,799
2006,3,Austria,86,607,99,0,792,223,1015
2006,3,Rusia,175,855,187,38,1255,1671,2926
2006,3,Países del Este,279,443,179,28,929,832,1761
2006,3,Resto de Europa,113,770,1050,0,1933,756,2689
2006,3,Estados Unidos,332,137,22,0,491,125,616
2006,3,Resto de América,424,47,22,5,498,42,540
2006,3,Resto del Mundo,570,128,139,0,837,102,939
2006,4,España,4745,18608,6577,81,30011,9132,39143
2006,4,Holanda,371,2519,676,8,3574,2403,5977
2006,4,Bélgica,832,4720,314,0,5866,900,6766
2006,4,Alemania,2898,15978,5036,19,23931,5309,29240
2006,4,Francia,292,1984,729,81,3086,1874,4960
2006,4,Gran Bretaña,4620,18089,5529,424,28662,31848,60510
2006,4,Irlanda,145,111,52,0,308,734,1042
2006,4,Italia,498,2276,315,18,3107,603,3710
2006,4,Suecia,109,1753,391,3,2256,1596,3852
2006,4,Noruega,116,420,347,8,891,565,1456
2006,4,Dinamarca,71,790,766,806,2433,1046,3479
2006,4,Finlandia,26,440,263,0,729,1069,1798
2006,4,Suiza,126,315,292,0,733,200,933
2006,4,Austria,163,766,127,0,1056,304,1360
2006,4,Rusia,667,1328,226,48,2269,1604,3873
2006,4,Países del Este,388,382,140,8,918,635,1553
2006,4,Resto de Europa,272,1050,703,5,2030,760,2790
2006,4,Estados Unidos,101,340,50,5,496,119,615
2006,4,Resto de América,28,145,59,13,245,47,292
2006,4,Resto del Mundo,384,84,125,3,596,97,693
2006,5,España,3498,16768,4758,70,25094,4503,29597
2006,5,Holanda,407,2823,623,8,3861,2458,6319
2006,5,Bélgica,541,2788,202,0,3531,455,3986
2006,5,Alemania,1275,11612,3251,21,16159,3123,19282
2006,5,Francia,232,1081,993,13,2319,616,2935
2006,5,Gran Bretaña,4494,16664,5736,496,27390,27178,54568
2006,5,Irlanda,192,34,32,0,258,1056,1314
2006,5,Italia,235,2640,458,1,3334,302,3636
2006,5,Suecia,1,4,8,1,14,53,67
2006,5,Noruega,5,2,15,0,22,4,26
2006,5,Dinamarca,35,6,7,693,741,76,817
2006,5,Finlandia,13,126,117,0,256,23,279
2006,5,Suiza,168,342,166,0,676,121,797
2006,5,Austria,92,623,12,0,727,198,925
2006,5,Rusia,390,943,384,20,1737,1647,3384
2006,5,Países del Este,250,382,99,10,741,767,1508
2006,5,Resto de Europa,161,985,289,0,1435,247,1682
2006,5,Estados Unidos,124,134,21,12,291,83,374
2006,5,Resto de América,63,42,52,0,157,76,233
2006,5,Resto del Mundo,284,145,19,3,451,138,589
2006,6,España,4623,18291,5710,65,28689,5854,34543
2006,6,Holanda,354,1997,386,0,2737,1776,4513
2006,6,Bélgica,467,2966,212,13,3658,587,4245
2006,6,Alemania,1509,13102,3298,11,17920,3521,21441
2006,6,Francia,218,809,348,13,1388,440,1828
2006,6,Gran Bretaña,3595,17884,6617,605,28701,35242,63943
2006,6,Irlanda,103,54,54,8,219,1262,1481
2006,6,Italia,90,2439,342,3,2874,741,3615
2006,6,Suecia,20,9,3,0,32,71,103
2006,6,Noruega,11,2,3,1,17,28,45
2006,6,Dinamarca,9,2,0,569,580,87,667
2006,6,Finlandia,5,128,71,15,219,98,317
2006,6,Suiza,149,346,151,0,646,139,785
2006,6,Austria,120,688,10,0,818,214,1032
2006,6,Rusia,461,1172,147,51,1831,2428,4259
2006,6,Países del Este,274,791,219,15,1299,1981,3280
2006,6,Resto de Europa,204,1624,591,0,2419,324,2743
2006,6,Estados Unidos,86,130,105,0,321,220,541
2006,6,Resto de América,45,41,38,0,124,51,175
2006,6,Resto del Mundo,548,409,14,0,971,515,1486
2006,7,España,6054,22294,5987,93,34428,11268,45696
2006,7,Holanda,349,2776,1343,15,4483,3518,8001
2006,7,Bélgica,461,5178,322,13,5974,1064,7038
2006,7,Alemania,996,9647,5271,19,15933,4012,19945
2006,7,Francia,216,957,248,9,1430,1630,3060
2006,7,Gran Bretaña,3487,16862,5668,526,26543,32658,59201
2006,7,Irlanda,89,101,48,9,247,1550,1797
2006,7,Italia,146,2795,866,0,3807,1385,5192
2006,7,Suecia,10,195,17,5,227,126,353
2006,7,Noruega,17,249,6,1,273,130,403
2006,7,Dinamarca,35,191,9,527,762,124,886
2006,7,Finlandia,17,89,21,0,127,24,151
2006,7,Suiza,101,602,152,0,855,458,1313
2006,7,Austria,82,729,80,0,891,465,1356
2006,7,Rusia,514,1023,152,76,1765,1705,3470
2006,7,Países del Este,433,1055,386,20,1894,1771,3665
2006,7,Resto de Europa,354,2336,625,9,3324,988,4312
2006,7,Estados Unidos,111,71,107,3,292,208,500
2006,7,Resto de América,108,67,53,3,231,115,346
2006,7,Resto del Mundo,431,272,12,6,721,588,1309
2006,8,España,9004,23853,8041,99,40997,16967,57964
2006,8,Holanda,235,1925,909,6,3075,2156,5231
2006,8,Bélgica,424,4477,273,2,5176,772,5948
2006,8,Alemania,1671,10970,4566,12,17219,3866,21085
2006,8,Francia,320,1260,326,43,1949,1659,3608
2006,8,Gran Bretaña,2781,16360,5750,727,25618,33994,59612
2006,8,Irlanda,77,23,121,0,221,1108,1329
2006,8,Italia,255,3758,2819,9,6841,2969,9810
2006,8,Suecia,4,348,10,1,363,81,444
2006,8,Noruega,2,219,30,4,255,31,286
2006,8,Dinamarca,10,181,20,709,920,63,983
2006,8,Finlandia,1,3,14,1,19,0,19
2006,8,Suiza,167,363,205,28,763,70,833
2006,8,Austria,207,611,49,0,867,296,1163
2006,8,Rusia,543,1111,159,72,1885,2041,3926
2006,8,Países del Este,484,923,384,14,1805,1792,3597
2006,8,Resto de Europa,577,2570,765,8,3920,756,4676
2006,8,Estados Unidos,85,60,16,10,171,94,265
2006,8,Resto de América,110,266,73,0,449,129,578
2006,8,Resto del Mundo,334,107,18,0,459,419,878
2006,9,España,4778,21591,4887,74,31330,10012,41342
2006,9,Holanda,188,2409,475,25,3097,1876,4973
2006,9,Bélgica,602,2671,281,4,3558,1122,4680
2006,9,Alemania,1722,13900,3855,14,19491,4265,23756
2006,9,Francia,216,714,240,0,1170,978,2148
2006,9,Gran Bretaña,5225,19217,5962,1119,31523,33908,65431
2006,9,Irlanda,156,82,95,2,335,1082,1417
2006,9,Italia,44,2157,675,4,2880,794,3674
2006,9,Suecia,15,290,27,0,332,47,379
2006,9,Noruega,5,286,71,0,362,51,413
2006,9,Dinamarca,9,101,3,559,672,55,727
2006,9,Finlandia,26,48,60,0,134,60,194
2006,9,Suiza,220,478,148,0,846,270,1116
2006,9,Austria,115,736,39,0,890,131,1021
2006,9,Rusia,479,1060,235,49,1823,2526,4349
2006,9,Países del Este,172,942,390,0,1504,2182,3686
2006,9,Resto de Europa,190,1585,522,0,2297,590,2887
2006,9,Estados Unidos,99,47,7,4,157,113,270
2006,9,Resto de América,49,51,34,2,136,97,233
2006,9,Resto del Mundo,699,49,45,7,800,144,944
2006,10,España,4846,15195,2682,79,22802,5806,28608
2006,10,Holanda,640,3685,981,23,5329,3437,8766
2006,10,Bélgica,872,3874,219,23,4988,799,5787
2006,10,Alemania,2711,12735,3821,22,19289,4817,24106
2006,10,Francia,264,1177,480,45,1966,1547,3513
2006,10,Gran Bretaña,5982,23057,7454,922,37415,36584,73999
2006,10,Irlanda,259,100,88,8,455,1304,1759
2006,10,Italia,620,2783,715,0,4118,661,4779
2006,10,Suecia,309,2478,683,30,3500,1094,4594
2006,10,Noruega,97,694,584,0,1375,752,2127
2006,10,Dinamarca,133,869,242,835,2079,1120,3199
2006,10,Finlandia,92,390,473,10,965,836,1801
2006,10,Suiza,295,774,334,16,1419,340,1759
2006,10,Austria,168,833,152,8,1161,301,1462
2006,10,Rusia,254,950,346,20,1570,2129,3699
2006,10,Países del Este,375,1119,261,0,1755,1503,3258
2006,10,Resto de Europa,336,888,410,6,1640,604,2244
2006,10,Estados Unidos,82,63,46,0,191,119,310
2006,10,Resto de América,33,39,22,4,98,15,113
2006,10,Resto del Mundo,727,119,30,4,880,98,978
2006,11,España,2532,10855,2017,28,15432,1826,17258
2006,11,Holanda,350,1655,482,47,2534,1452,3986
2006,11,Bélgica,808,2351,604,22,3785,870,4655
2006,11,Alemania,4407,13330,3052,41,20830,4629,25459
2006,11,Francia,224,543,329,80,1176,1291,2467
2006,11,Gran Bretaña,6202,18505,7496,918,33121,30547,63668
2006,11,Irlanda,314,121,49,8,492,675,1167
2006,11,Italia,581,2102,408,2,3093,457,3550
2006,11,Suecia,266,3611,765,8,4650,1645,6295
2006,11,Noruega,149,1083,851,0,2083,1351,3434
2006,11,Dinamarca,66,1185,245,777,2273,1464,3737
2006,11,Finlandia,291,710,733,12,1746,1147,2893
2006,11,Suiza,307,422,280,27,1036,210,1246
2006,11,Austria,254,675,329,0,1258,315,1573
2006,11,Rusia,96,1276,394,18,1784,1783,3567
2006,11,Países del Este,1032,1484,557,0,3073,1032,4105
2006,11,Resto de Europa,261,337,685,4,1287,759,2046
2006,11,Estados Unidos,64,80,126,1,271,39,310
2006,11,Resto de América,25,44,27,0,96,35,131
2006,11,Resto del Mundo,501,97,43,12,653,76,729
2006,12,España,3172,12096,2335,16,17619,3398,21017
2006,12,Holanda,363,1878,551,22,2814,1741,4555
2006,12,Bélgica,914,3202,669,41,4826,1058,5884
2006,12,Alemania,2613,10265,2042,23,14943,3988,18931
2006,12,Francia,236,858,376,38,1508,1477,2985
2006,12,Gran Bretaña,5820,21253,7514,1207,35794,33970,69764
2006,12,Irlanda,216,167,36,10,429,843,1272
2006,12,Italia,289,2705,848,4,3846,1204,5050
2006,12,Suecia,55,3088,860,15,4018,1830,5848
2006,12,Noruega,35,684,500,1,1220,1286,2506
2006,12,Dinamarca,26,1047,944,1029,3046,1809,4855
2006,12,Finlandia,147,552,772,10,1481,2132,3613
2006,12,Suiza,119,399,383,0,901,200,1101
2006,12,Austria,115,560,165,0,840,334,1174
2006,12,Rusia,168,1089,495,13,1765,2331,4096
2006,12,Países del Este,258,926,341,4,1529,1362,2891
2006,12,Resto de Europa,279,695,703,4,1681,1099,2780
2006,12,Estados Unidos,91,61,93,4,249,76,325
2006,12,Resto de América,40,66,49,2,157,17,174
2006,12,Resto del Mundo,455,150,57,0,662,366,1028
2006,13,España,52463,188694,48807,711,290675,75689,366364
2006,13,Holanda,4504,28411,9002,200,42117,28221,70338
2006,13,Bélgica,8256,42420,4969,186,55831,10114,65945
2006,13,Alemania,26235,154365,47595,372,228567,50089,278656
2006,13,Francia,3214,12926,5217,528,21885,16229,38114
2006,13,Gran Bretaña,56387,222074,78796,8903,366160,390344,756504
2006,13,Irlanda,2053,1078,643,50,3824,11470,15294
2006,13,Italia,3362,35804,8652,54,47872,12489,60361
2006,13,Suecia,1227,19701,4523,63,25514,17379,42893
2006,13,Noruega,749,5526,4384,21,10680,9312,19992
2006,13,Dinamarca,693,7278,5738,9128,22837,13183,36020
2006,13,Finlandia,782,4670,4002,71,9525,16418,25943
2006,13,Suiza,2074,5168,2376,99,9717,2380,12097
2006,13,Austria,1707,8083,1248,21,11059,3328,14387
2006,13,Rusia,4129,12034,3270,486,19919,22614,42533
2006,13,Países del Este,4532,9249,3415,117,17313,15601,32914
2006,13,Resto de Europa,3013,13984,7741,49,24787,8500,33287
2006,13,Estados Unidos,1295,1261,618,44,3218,2087,5305
2006,13,Resto de América,1001,911,458,49,2419,709,3128
2006,13,Resto del Mundo,5734,2081,722,35,8572,2772,11344
2007,1,España,1927,8222,2146,11,12306,1735,14041
2007,1,Holanda,378,1789,763,18,2948,1640,4588
2007,1,Bélgica,891,3261,768,22,4942,624,5566
2007,1,Alemania,3075,11212,2159,21,16467,3678,20145
2007,1,Francia,194,1503,346,94,2137,1212,3349
2007,1,Gran Bretaña,4632,16714,6222,976,28544,29990,58534
2007,1,Irlanda,220,142,31,6,399,797,1196
2007,1,Italia,396,4535,981,12,5924,1336,7260
2007,1,Suecia,65,2962,592,2,3621,2057,5678
2007,1,Noruega,59,776,616,8,1459,1469,2928
2007,1,Dinamarca,60,1145,1188,718,3111,3218,6329
2007,1,Finlandia,150,807,793,6,1756,2048,3804
2007,1,Suiza,105,323,250,6,684,107,791
2007,1,Austria,226,667,211,0,1104,424,1528
2007,1,Rusia,253,1079,366,47,1745,1833,3578
2007,1,Países del Este,266,1182,379,4,1831,1416,3247
2007,1,Resto de Europa,317,556,618,6,1497,986,2483
2007,1,Estados Unidos,65,38,58,0,161,113,274
2007,1,Resto de América,29,56,48,0,133,62,195
2007,1,Resto del Mundo,345,99,18,0,462,268,730
2007,2,España,2439,9811,2020,12,14282,2424,16706
2007,2,Holanda,341,2233,955,42,3571,2117,5688
2007,2,Bélgica,952,3208,523,16,4699,839,5538
2007,2,Alemania,2806,10619,2948,24,16397,4188,20585
2007,2,Francia,274,1502,639,57,2472,1930,4402
2007,2,Gran Bretaña,5797,16649,6908,1045,30399,32084,62483
2007,2,Irlanda,275,123,34,4,436,857,1293
2007,2,Italia,458,2952,484,2,3896,996,4892
2007,2,Suecia,159,3359,750,0,4268,1887,6155
2007,2,Noruega,142,847,909,0,1898,1468,3366
2007,2,Dinamarca,119,1629,1345,860,3953,2274,6227
2007,2,Finlandia,202,819,664,0,1685,2137,3822
2007,2,Suiza,190,290,148,22,650,86,736
2007,2,Austria,252,482,132,0,866,356,1222
2007,2,Rusia,56,543,292,0,891,1264,2155
2007,2,Países del Este,147,895,394,2,1438,1017,2455
2007,2,Resto de Europa,255,495,627,8,1385,994,2379
2007,2,Estados Unidos,74,54,60,0,188,110,298
2007,2,Resto de América,40,45,45,12,142,68,210
2007,2,Resto del Mundo,384,92,22,3,501,298,799
2007,3,España,1804,10620,1775,59,14258,2858,17116
2007,3,Holanda,359,2319,901,35,3614,2319,5933
2007,3,Bélgica,732,3179,577,17,4505,940,5445
2007,3,Alemania,3067,14833,3992,15,21907,5475,27382
2007,3,Francia,196,1703,772,76,2747,1953,4700
2007,3,Gran Bretaña,5396,20719,7973,1210,35298,40243,75541
2007,3,Irlanda,309,209,60,0,578,965,1543
2007,3,Italia,262,3168,375,2,3807,593,4400
2007,3,Suecia,349,3105,807,9,4270,2002,6272
2007,3,Noruega,176,931,823,2,1932,1728,3660
2007,3,Dinamarca,104,1258,1711,796,3869,2291,6160
2007,3,Finlandia,142,809,850,20,1821,1862,3683
2007,3,Suiza,158,361,151,22,692,101,793
2007,3,Austria,242,727,109,0,1078,260,1338
2007,3,Rusia,295,779,327,24,1425,1730,3155
2007,3,Países del Este,209,984,427,0,1620,1159,2779
2007,3,Resto de Europa,172,763,598,6,1539,1013,2552
2007,3,Estados Unidos,96,125,120,2,343,198,541
2007,3,Resto de América,56,78,33,4,171,80,251
2007,3,Resto del Mundo,482,216,9,0,707,400,1107
2007,4,España,3836,16738,5070,65,25709,7080,32789
2007,4,Holanda,393,2954,623,4,3974,2360,6334
2007,4,Bélgica,1077,3947,383,0,5407,783,6190
2007,4,Alemania,2913,13960,4445,16,21334,4112,25446
2007,4,Francia,382,1750,504,49,2685,1887,4572
2007,4,Gran Bretaña,5729,18003,4776,956,29464,29673,59137
2007,4,Irlanda,195,151,26,0,372,985,1357
2007,4,Italia,467,2556,537,8,3568,480,4048
2007,4,Suecia,74,2230,288,0,2592,826,3418
2007,4,Noruega,67,604,306,0,977,546,1523
2007,4,Dinamarca,28,867,788,0,1683,987,2670
2007,4,Finlandia,102,390,317,6,815,598,1413
2007,4,Suiza,226,448,113,0,787,90,877
2007,4,Austria,175,543,88,0,806,284,1090
2007,4,Rusia,406,911,266,33,1616,1925,3541
2007,4,Países del Este,373,1111,382,2,1868,704,2572
2007,4,Resto de Europa,274,936,429,6,1645,994,2639
2007,4,Estados Unidos,63,73,27,0,163,181,344
2007,4,Resto de América,33,55,67,2,157,71,228
2007,4,Resto del Mundo,385,104,24,0,513,290,803
2007,5,España,3650,15237,3996,82,22965,3673,26638
2007,5,Holanda,377,2186,459,12,3034,1644,4678
2007,5,Bélgica,594,2192,144,6,2936,622,3558
2007,5,Alemania,1797,10907,2575,8,15287,2685,17972
2007,5,Francia,375,863,228,4,1470,468,1938
2007,5,Gran Bretaña,3940,16589,3599,909,25037,22330,47367
2007,5,Irlanda,230,114,39,0,383,951,1334
2007,5,Italia,332,1744,217,14,2307,337,2644
2007,5,Suecia,29,20,7,0,56,56,112
2007,5,Noruega,15,7,0,0,22,4,26
2007,5,Dinamarca,44,62,4,0,110,202,312
2007,5,Finlandia,1,5,3,0,9,24,33
2007,5,Suiza,199,374,96,31,700,97,797
2007,5,Austria,114,479,27,0,620,107,727
2007,5,Rusia,491,685,146,39,1361,1623,2984
2007,5,Países del Este,210,550,376,0,1136,330,1466
2007,5,Resto de Europa,271,1016,319,0,1606,753,2359
2007,5,Estados Unidos,173,44,19,0,236,161,397
2007,5,Resto de América,48,167,19,0,234,52,286
2007,5,Resto del Mundo,302,54,13,6,375,125,500
2007,6,España,4794,19511,5804,49,30158,9330,39488
2007,6,Holanda,241,1789,385,4,2419,1228,3647
2007,6,Bélgica,476,2754,162,0,3392,554,3946
2007,6,Alemania,1710,11765,4096,12,17583,3158,20741
2007,6,Francia,281,826,187,0,1294,896,2190
2007,6,Gran Bretaña,3261,17984,5389,1218,27852,25323,53175
2007,6,Irlanda,203,175,44,4,426,986,1412
2007,6,Italia,115,2405,202,8,2730,802,3532
2007,6,Suecia,27,22,0,0,49,64,113
2007,6,Noruega,5,0,10,0,15,38,53
2007,6,Dinamarca,24,50,3,0,77,310,387
2007,6,Finlandia,6,1,6,0,13,24,37
2007,6,Suiza,200,389,92,4,685,204,889
2007,6,Austria,123,682,17,0,822,286,1108
2007,6,Rusia,678,1590,257,49,2574,1844,4418
2007,6,Países del Este,301,1007,449,0,1757,1818,3575
2007,6,Resto de Europa,584,2190,542,27,3343,1004,4347
2007,6,Estados Unidos,105,92,11,0,208,136,344
2007,6,Resto de América,44,102,42,0,188,52,240
2007,6,Resto del Mundo,246,156,62,2,466,398,864
2007,7,España,5709,24645,4926,60,35340,13819,49159
2007,7,Holanda,397,3482,1149,13,5041,3052,8093
2007,7,Bélgica,705,4389,225,9,5328,1196,6524
2007,7,Alemania,1226,10112,4576,24,15938,3192,19130
2007,7,Francia,231,1109,321,35,1696,1487,3183
2007,7,Gran Bretaña,3260,16354,5344,969,25927,22583,48510
2007,7,Irlanda,164,124,45,0,333,1098,1431
2007,7,Italia,144,2956,767,0,3867,1581,5448
2007,7,Suecia,25,147,22,0,194,86,280
2007,7,Noruega,19,241,21,0,281,63,344
2007,7,Dinamarca,26,401,12,0,439,153,592
2007,7,Finlandia,6,3,5,0,14,15,29
2007,7,Suiza,135,487,185,0,807,350,1157
2007,7,Austria,155,687,103,0,945,304,1249
2007,7,Rusia,622,1130,376,13,2141,2413,4554
2007,7,Países del Este,380,1245,571,22,2218,1458,3676
2007,7,Resto de Europa,936,2189,741,13,3879,1487,5366
2007,7,Estados Unidos,117,55,11,0,183,134,317
2007,7,Resto de América,63,86,53,0,202,92,294
2007,7,Resto del Mundo,322,120,15,0,457,526,983
2007,8,España,7632,24982,7692,87,40393,20765,61158
2007,8,Holanda,257,2192,758,17,3224,2058,5282
2007,8,Bélgica,580,4532,609,0,5721,1787,7508
2007,8,Alemania,1398,10967,5297,2,17664,3770,21434
2007,8,Francia,329,1463,510,28,2330,2253,4583
2007,8,Gran Bretaña,3066,15891,6153,1181,26291,29527,55818
2007,8,Irlanda,129,195,47,4,375,1066,1441
2007,8,Italia,265,3591,2130,50,6036,3306,9342
2007,8,Suecia,7,191,16,0,214,61,275
2007,8,Noruega,10,198,0,0,208,38,246
2007,8,Dinamarca,14,303,4,0,321,63,384
2007,8,Finlandia,2,2,0,0,4,27,31
2007,8,Suiza,168,330,66,0,564,186,750
2007,8,Austria,104,624,108,0,836,374,1210
2007,8,Rusia,666,1305,420,24,2415,2662,5077
2007,8,Países del Este,314,1297,498,11,2120,1760,3880
2007,8,Resto de Europa,1379,2025,775,13,4192,1655,5847
2007,8,Estados Unidos,104,77,11,6,198,67,265
2007,8,Resto de América,55,46,66,4,171,75,246
2007,8,Resto del Mundo,195,220,22,0,437,428,865
2007,9,España,4702,20238,3989,61,28990,9277,38267
2007,9,Holanda,320,2178,601,4,3103,1433,4536
2007,9,Bélgica,648,2266,416,4,3334,485,3819
2007,9,Alemania,2419,10271,4352,1,17043,4137,21180
2007,9,Francia,336,933,278,17,1564,1126,2690
2007,9,Gran Bretaña,3850,15515,5149,1050,25564,22681,48245
2007,9,Irlanda,111,158,78,0,347,1298,1645
2007,9,Italia,176,2141,610,6,2933,741,3674
2007,9,Suecia,10,172,58,0,240,31,271
2007,9,Noruega,10,287,5,4,306,48,354
2007,9,Dinamarca,5,271,8,521,805,344,1149
2007,9,Finlandia,7,7,0,0,14,21,35
2007,9,Suiza,244,349,110,0,703,236,939
2007,9,Austria,146,592,82,0,820,271,1091
2007,9,Rusia,982,1701,346,19,3048,2315,5363
2007,9,Países del Este,346,964,476,9,1795,2129,3924
2007,9,Resto de Europa,827,1850,518,11,3206,822,4028
2007,9,Estados Unidos,42,44,0,3,89,95,184
2007,9,Resto de América,30,101,49,6,186,66,252
2007,9,Resto del Mundo,487,91,19,4,601,126,727
2007,10,España,3472,17471,2664,32,23639,6369,30008
2007,10,Holanda,439,3616,1112,19,5186,2558,7744
2007,10,Bélgica,1097,3354,370,15,4836,635,5471
2007,10,Alemania,2673,10195,4607,15,17490,5047,22537
2007,10,Francia,221,1043,285,67,1616,1480,3096
2007,10,Gran Bretaña,6862,22528,6784,1079,37253,28975,66228
2007,10,Irlanda,298,339,53,2,692,983,1675
2007,10,Italia,203,1641,435,16,2295,466,2761
2007,10,Suecia,65,2557,588,577,3787,1426,5213
2007,10,Noruega,83,739,668,0,1490,1292,2782
2007,10,Dinamarca,48,1431,307,0,1786,1706,3492
2007,10,Finlandia,104,726,418,11,1259,1755,3014
2007,10,Suiza,260,752,165,4,1181,244,1425
2007,10,Austria,187,664,73,0,924,288,1212
2007,10,Rusia,273,1354,396,28,2051,2890,4941
2007,10,Países del Este,306,1355,333,4,1998,1871,3869
2007,10,Resto de Europa,544,1351,882,2,2779,1358,4137
2007,10,Estados Unidos,79,41,4,0,124,89,213
2007,10,Resto de América,50,54,40,0,144,31,175
2007,10,Resto del Mundo,350,51,15,3,419,435,854
2007,11,España,1923,8727,1683,77,12410,3664,16074
2007,11,Holanda,423,2051,848,9,3331,2081,5412
2007,11,Bélgica,892,2726,713,26,4357,872,5229
2007,11,Alemania,3679,13452,5183,25,22339,4475,26814
2007,11,Francia,147,606,306,41,1100,1520,2620
2007,11,Gran Bretaña,6164,21562,6974,1393,36093,31360,67453
2007,11,Irlanda,252,240,97,0,589,1053,1642
2007,11,Italia,319,1452,302,4,2077,644,2721
2007,11,Suecia,130,3560,711,2,4403,2426,6829
2007,11,Noruega,124,1444,1011,0,2579,2113,4692
2007,11,Dinamarca,37,1355,379,583,2354,3048,5402
2007,11,Finlandia,243,912,629,30,1814,2593,4407
2007,11,Suiza,260,407,100,24,791,207,998
2007,11,Austria,323,846,131,0,1300,425,1725
2007,11,Rusia,239,1465,550,30,2284,2619,4903
2007,11,Países del Este,154,1105,379,9,1647,2143,3790
2007,11,Resto de Europa,422,1133,1475,2,3032,1127,4159
2007,11,Estados Unidos,46,45,13,0,104,92,196
2007,11,Resto de América,17,57,23,0,97,50,147
2007,11,Resto del Mundo,106,80,76,0,262,301,563
2007,12,España,1978,7578,1201,55,10812,2570,13382
2007,12,Holanda,387,2113,749,71,3320,1507,4827
2007,12,Bélgica,811,3378,528,17,4734,1437,6171
2007,12,Alemania,3038,10197,4368,19,17622,3084,20706
2007,12,Francia,338,1075,300,56,1769,1668,3437
2007,12,Gran Bretaña,5793,19336,6837,1028,32994,28827,61821
2007,12,Irlanda,251,441,178,9,879,1137,2016
2007,12,Italia,197,1912,608,24,2741,908,3649
2007,12,Suecia,66,2941,481,17,3505,2107,5612
2007,12,Noruega,61,1027,1007,2,2097,1294,3391
2007,12,Dinamarca,32,1938,1045,717,3732,2989,6721
2007,12,Finlandia,210,1003,481,19,1713,2178,3891
2007,12,Suiza,196,351,101,6,654,138,792
2007,12,Austria,227,458,115,0,800,182,982
2007,12,Rusia,165,913,608,9,1695,1693,3388
2007,12,Países del Este,220,1393,299,9,1921,1418,3339
2007,12,Resto de Europa,626,1001,1223,0,2850,1226,4076
2007,12,Estados Unidos,68,43,8,0,119,105,224
2007,12,Resto de América,41,79,25,2,147,78,225
2007,12,Resto del Mundo,294,93,30,3,420,524,944
2007,13,España,43866,183780,42966,650,271262,83564,354826
2007,13,Holanda,4312,28902,9303,248,42765,23997,66762
2007,13,Bélgica,9455,39186,5418,132,54191,10774,64965
2007,13,Alemania,29801,138490,48598,182,217071,47001,264072
2007,13,Francia,3304,14376,4676,524,22880,17880,40760
2007,13,Gran Bretaña,57750,217844,72108,13014,360716,343596,704312
2007,13,Irlanda,2637,2411,732,29,5809,12176,17985
2007,13,Italia,3334,31053,7648,146,42181,12190,54371
2007,13,Suecia,1006,21266,4320,607,27199,13029,40228
2007,13,Noruega,771,7101,5376,16,13264,10101,23365
2007,13,Dinamarca,541,10710,6794,4195,22240,17585,39825
2007,13,Finlandia,1175,5484,4166,92,10917,13282,24199
2007,13,Suiza,2341,4861,1577,119,8898,2046,10944
2007,13,Austria,2274,7451,1196,0,10921,3561,14482
2007,13,Rusia,5126,13455,4350,315,23246,24811,48057
2007,13,Países del Este,3226,13088,4963,72,21349,17223,38572
2007,13,Resto de Europa,6607,15505,8747,94,30953,13419,44372
2007,13,Estados Unidos,1032,731,342,11,2116,1481,3597
2007,13,Resto de América,506,926,510,30,1972,777,2749
2007,13,Resto del Mundo,3898,1376,325,21,5620,4119,9739
2008,1,España,2106,7955,1604,31,11696,2645,14341
2008,1,Holanda,318,2095,719,51,3183,1892,5075
2008,1,Bélgica,736,3224,779,4,4743,843,5586
2008,1,Alemania,2664,10830,3914,26,17434,4387,21821
2008,1,Francia,283,1754,363,47,2447,1694,4141
2008,1,Gran Bretaña,3662,17323,7036,1017,29038,25870,54908
2008,1,Irlanda,253,612,44,0,909,1589,2498
2008,1,Italia,232,2497,785,12,3526,1167,4693
2008,1,Suecia,202,2811,442,9,3464,1696,5160
2008,1,Noruega,177,893,782,1,1853,1425,3278
2008,1,Dinamarca,95,1303,1405,528,3331,2907,6238
2008,1,Finlandia,168,1080,442,4,1694,1563,3257
2008,1,Suiza,128,247,119,21,515,83,598
2008,1,Austria,249,585,142,0,976,303,1279
2008,1,Rusia,575,1001,692,47,2315,2557,4872
2008,1,Países del Este,359,1126,421,14,1920,1508,3428
2008,1,Resto de Europa,523,1034,1546,0,3103,1933,5036
2008,1,Estados Unidos,56,38,3,0,97,95,192
2008,1,Resto de América,49,58,20,12,139,65,204
2008,1,Resto del Mundo,206,48,9,0,263,263,526
2008,2,España,1687,10367,1876,42,13972,2760,16732
2008,2,Holanda,601,2734,1192,82,4609,3624,8233
2008,2,Bélgica,922,3764,549,23,5258,687,5945
2008,2,Alemania,2645,11495,4493,11,18644,3990,22634
2008,2,Francia,332,2032,629,59,3052,2532,5584
2008,2,Gran Bretaña,6579,20646,7435,1296,35956,33205,69161
2008,2,Irlanda,441,487,37,0,965,1388,2353
2008,2,Italia,198,1928,491,13,2630,955,3585
2008,2,Suecia,74,2636,485,1,3196,1707,4903
2008,2,Noruega,95,1224,843,0,2162,1458,3620
2008,2,Dinamarca,115,1515,1400,595,3625,3121,6746
2008,2,Finlandia,213,855,468,35,1571,2229,3800
2008,2,Suiza,160,466,66,5,697,86,783
2008,2,Austria,236,644,142,0,1022,387,1409
2008,2,Rusia,112,954,424,25,1515,1735,3250
2008,2,Países del Este,279,1176,321,0,1776,1697,3473
2008,2,Resto de Europa,767,862,1625,0,3254,1663,4917
2008,2,Estados Unidos,48,81,0,1,130,100,230
2008,2,Resto de América,22,45,11,4,82,50,132
2008,2,Resto del Mundo,354,44,3,4,405,359,764
2008,3,España,2768,13748,4470,46,21032,6099,27131
2008,3,Holanda,499,2338,798,57,3692,2918,6610
2008,3,Bélgica,1129,4099,383,10,5621,1198,6819
2008,3,Alemania,4050,15317,5608,26,25001,5268,30269
2008,3,Francia,260,1634,388,17,2299,2024,4323
2008,3,Gran Bretaña,5572,20896,6542,1175,34185,30170,64355
2008,3,Irlanda,384,556,48,0,988,2009,2997
2008,3,Italia,151,1796,399,12,2358,701,3059
2008,3,Suecia,109,3688,683,1,4481,1978,6459
2008,3,Noruega,124,1517,1042,1,2684,1525,4209
2008,3,Dinamarca,94,1935,1778,732,4539,3656,8195
2008,3,Finlandia,166,881,509,4,1560,2287,3847
2008,3,Suiza,172,407,91,0,670,116,786
2008,3,Austria,265,614,115,4,998,221,1219
2008,3,Rusia,130,1089,410,4,1633,1833,3466
2008,3,Países del Este,176,1174,274,0,1624,1898,3522
2008,3,Resto de Europa,706,1287,1314,8,3315,1173,4488
2008,3,Estados Unidos,58,121,41,21,241,176,417
2008,3,Resto de América,31,56,7,1,95,35,130
2008,3,Resto del Mundo,549,87,22,0,658,488,1146
2008,4,España,3486,10988,6988,68,21530,3186,24716
2008,4,Holanda,612,3623,816,14,5065,3184,8249
2008,4,Bélgica,926,2897,250,7,4080,351,4431
2008,4,Alemania,2912,14200,4625,23,21760,3682,25442
2008,4,Francia,442,1637,582,47,2708,2473,5181
2008,4,Gran Bretaña,5328,19090,5324,953,30695,27485,58180
2008,4,Irlanda,279,293,29,7,608,1634,2242
2008,4,Italia,180,1464,318,6,1968,571,2539
2008,4,Suecia,63,1332,425,0,1820,755,2575
2008,4,Noruega,62,408,99,8,577,423,1000
2008,4,Dinamarca,36,825,337,487,1685,1026,2711
2008,4,Finlandia,43,318,104,10,475,619,1094
2008,4,Suiza,243,477,104,0,824,123,947
2008,4,Austria,227,467,110,0,804,220,1024
2008,4,Rusia,384,1653,326,21,2384,2188,4572
2008,4,Países del Este,198,1332,348,0,1878,2121,3999
2008,4,Resto de Europa,394,1515,782,0,2691,921,3612
2008,4,Estados Unidos,71,95,16,8,190,166,356
2008,4,Resto de América,19,60,22,3,104,41,145
2008,4,Resto del Mundo,462,226,10,14,712,295,1007
2008,5,España,4938,17722,7227,85,29972,7848,37820
2008,5,Holanda,561,2664,571,8,3804,1855,5659
2008,5,Bélgica,720,1873,115,4,2712,339,3051
2008,5,Alemania,2942,11095,4346,8,18391,4544,22935
2008,5,Francia,304,1051,252,39,1646,1211,2857
2008,5,Gran Bretaña,4370,18700,5516,1361,29947,25175,55122
2008,5,Irlanda,428,691,121,0,1240,1356,2596
2008,5,Italia,122,1749,154,0,2025,328,2353
2008,5,Suecia,128,23,4,6,161,115,276
2008,5,Noruega,56,109,9,8,182,173,355
2008,5,Dinamarca,39,10,14,339,402,352,754
2008,5,Finlandia,160,3,59,0,222,30,252
2008,5,Suiza,302,483,170,5,960,102,1062
2008,5,Austria,399,586,66,0,1051,284,1335
2008,5,Rusia,655,1826,296,21,2798,2936,5734
2008,5,Países del Este,160,3900,323,16,4399,2322,6721
2008,5,Resto de Europa,1003,1672,335,7,3017,461,3478
2008,5,Estados Unidos,71,90,6,0,167,87,254
2008,5,Resto de América,55,112,25,2,194,92,286
2008,5,Resto del Mundo,244,210,9,1,464,141,605
2008,6,España,4085,20783,6991,46,31905,8228,40133
2008,6,Holanda,410,2107,566,12,3095,1361,4456
2008,6,Bélgica,396,2311,171,21,2899,721,3620
2008,6,Alemania,2065,11368,3803,0,17236,4147,21383
2008,6,Francia,216,1012,276,2,1506,824,2330
2008,6,Gran Bretaña,4167,16908,5106,954,27135,23248,50383
2008,6,Irlanda,317,839,43,12,1211,1883,3094
2008,6,Italia,979,1977,179,12,3147,671,3818
2008,6,Suecia,23,220,0,0,243,173,416
2008,6,Noruega,23,205,11,2,241,121,362
2008,6,Dinamarca,7,179,1,381,568,359,927
2008,6,Finlandia,5,5,1,0,11,13,24
2008,6,Suiza,139,460,135,2,736,155,891
2008,6,Austria,125,413,58,0,596,207,803
2008,6,Rusia,373,1356,258,57,2044,3068,5112
2008,6,Países del Este,105,980,383,10,1478,1064,2542
2008,6,Resto de Europa,1070,2426,484,0,3980,940,4920
2008,6,Estados Unidos,98,71,3,0,172,67,239
2008,6,Resto de América,61,52,18,4,135,57,192
2008,6,Resto del Mundo,105,238,53,7,403,315,718
2008,7,España,6261,21386,4500,154,32301,13402,45703
2008,7,Holanda,471,2926,1216,18,4631,2909,7540
2008,7,Bélgica,686,2795,132,28,3641,768,4409
2008,7,Alemania,1223,10154,4198,10,15585,4000,19585
2008,7,Francia,167,1250,294,1,1712,2093,3805
2008,7,Gran Bretaña,3960,18676,5085,892,28613,25594,54207
2008,7,Irlanda,277,819,107,0,1203,1551,2754
2008,7,Italia,160,1526,571,4,2261,950,3211
2008,7,Suecia,21,239,1,2,263,241,504
2008,7,Noruega,14,373,0,8,395,213,608
2008,7,Dinamarca,9,486,29,461,985,399,1384
2008,7,Finlandia,0,1,4,2,7,31,38
2008,7,Suiza,138,497,321,4,960,294,1254
2008,7,Austria,182,465,105,0,752,432,1184
2008,7,Rusia,767,1229,235,25,2256,2749,5005
2008,7,Países del Este,695,1208,531,33,2467,1277,3744
2008,7,Resto de Europa,337,2894,753,6,3990,1321,5311
2008,7,Estados Unidos,67,71,1,0,139,123,262
2008,7,Resto de América,65,65,25,8,163,37,200
2008,7,Resto del Mundo,70,291,31,0,392,173,565
2008,8,España,5875,28783,7299,240,42197,21479,63676
2008,8,Holanda,256,2037,711,14,3018,2616,5634
2008,8,Bélgica,568,3138,353,12,4071,1050,5121
2008,8,Alemania,1456,10336,4394,14,16200,4529,20729
2008,8,Francia,383,1544,617,23,2567,3472,6039
2008,8,Gran Bretaña,2412,18595,5407,1284,27698,28977,56675
2008,8,Irlanda,145,786,89,8,1028,2080,3108
2008,8,Italia,286,2494,1512,32,4324,2516,6840
2008,8,Suecia,10,286,1,2,299,79,378
2008,8,Noruega,2,233,0,8,243,84,327
2008,8,Dinamarca,13,289,4,401,707,280,987
2008,8,Finlandia,2,1,0,10,13,25,38
2008,8,Suiza,127,470,153,6,756,190,946
2008,8,Austria,125,491,61,0,677,260,937
2008,8,Rusia,1120,1571,381,45,3117,2360,5477
2008,8,Países del Este,475,1577,506,29,2587,1053,3640
2008,8,Resto de Europa,763,3166,793,10,4732,1416,6148
2008,8,Estados Unidos,75,51,20,0,146,154,300
2008,8,Resto de América,33,71,38,6,148,117,265
2008,8,Resto del Mundo,184,378,26,23,611,122,733
2008,9,España,3883,17726,3526,113,25248,12070,37318
2008,9,Holanda,345,2067,572,4,2988,1811,4799
2008,9,Bélgica,595,2393,176,25,3189,425,3614
2008,9,Alemania,1894,10513,3512,12,15931,3249,19180
2008,9,Francia,428,655,130,13,1226,1216,2442
2008,9,Gran Bretaña,2764,17781,4315,966,25826,20678,46504
2008,9,Irlanda,242,887,89,8,1226,2047,3273
2008,9,Italia,128,1301,315,11,1755,627,2382
2008,9,Suecia,18,390,0,0,408,249,657
2008,9,Noruega,35,495,4,5,539,128,667
2008,9,Dinamarca,14,299,6,494,813,299,1112
2008,9,Finlandia,3,1,1,11,16,13,29
2008,9,Suiza,237,531,158,16,942,92,1034
2008,9,Austria,151,397,29,0,577,135,712
2008,9,Rusia,646,996,277,18,1937,2114,4051
2008,9,Países del Este,413,973,598,25,2009,2532,4541
2008,9,Resto de Europa,379,2268,550,0,3197,1254,4451
2008,9,Estados Unidos,50,37,1,0,88,88,176
2008,9,Resto de América,21,58,11,14,104,52,156
2008,9,Resto del Mundo,31,132,9,1,173,169,342
2008,10,España,2169,9701,4811,119,16800,7905,24705
2008,10,Holanda,477,3472,965,18,4932,3133,8065
2008,10,Bélgica,812,3490,217,8,4527,412,4939
2008,10,Alemania,2039,11135,4487,40,17701,4004,21705
2008,10,Francia,172,1204,321,26,1723,1963,3686
2008,10,Gran Bretaña,3413,21371,5913,1321,32018,28524,60542
2008,10,Irlanda,246,594,85,0,925,2514,3439
2008,10,Italia,66,1720,120,6,1912,344,2256
2008,10,Suecia,76,2199,645,0,2920,787,3707
2008,10,Noruega,55,815,719,13,1602,1083,2685
2008,10,Dinamarca,56,1344,207,408,2015,1399,3414
2008,10,Finlandia,73,839,251,54,1217,835,2052
2008,10,Suiza,202,633,137,33,1005,205,1210
2008,10,Austria,170,425,82,0,677,100,777
2008,10,Rusia,3562,3041,379,25,7007,2821,9828
2008,10,Países del Este,247,1054,262,12,1575,1422,2997
2008,10,Resto de Europa,129,1503,580,0,2212,1169,3381
2008,10,Estados Unidos,92,65,5,0,162,198,360
2008,10,Resto de América,11,107,40,4,162,61,223
2008,10,Resto del Mundo,139,253,11,3,406,66,472
2008,11,España,1703,8420,5224,23,15370,7752,23122
2008,11,Holanda,374,2111,635,28,3148,1842,4990
2008,11,Bélgica,895,3274,322,10,4501,543,5044
2008,11,Alemania,3212,13408,4184,52,20856,3862,24718
2008,11,Francia,238,721,321,31,1311,1666,2977
2008,11,Gran Bretaña,3360,17063,3748,929,25100,23674,48774
2008,11,Irlanda,198,342,58,0,598,1978,2576
2008,11,Italia,75,1854,79,3,2011,567,2578
2008,11,Suecia,121,3537,927,10,4595,1730,6325
2008,11,Noruega,131,1678,1203,4,3016,1889,4905
2008,11,Dinamarca,58,1817,503,740,3118,3601,6719
2008,11,Finlandia,124,794,478,18,1414,1168,2582
2008,11,Suiza,295,542,118,4,959,257,1216
2008,11,Austria,221,664,59,0,944,272,1216
2008,11,Rusia,354,1331,324,4,2013,1945,3958
2008,11,Países del Este,223,1179,191,10,1603,1621,3224
2008,11,Resto de Europa,234,1188,984,0,2406,978,3384
2008,11,Estados Unidos,58,76,16,1,151,170,321
2008,11,Resto de América,28,64,14,0,106,51,157
2008,11,Resto del Mundo,109,141,5,4,259,47,306
2008,12,España,1683,8558,5246,44,15531,6442,21973
2008,12,Holanda,260,2190,486,49,2985,2234,5219
2008,12,Bélgica,692,3650,303,12,4657,1104,5761
2008,12,Alemania,2471,9542,3372,53,15438,3437,18875
2008,12,Francia,215,708,289,27,1239,1466,2705
2008,12,Gran Bretaña,3740,17474,4359,1085,26658,25791,52449
2008,12,Irlanda,238,337,45,6,626,1541,2167
2008,12,Italia,213,2262,238,12,2725,736,3461
2008,12,Suecia,73,2916,650,4,3643,1715,5358
2008,12,Noruega,62,983,760,1,1806,1065,2871
2008,12,Dinamarca,14,1612,645,607,2878,2305,5183
2008,12,Finlandia,170,921,454,12,1557,1980,3537
2008,12,Suiza,144,390,78,2,614,232,846
2008,12,Austria,182,463,24,0,669,252,921
2008,12,Rusia,376,1105,293,8,1782,1573,3355
2008,12,Países del Este,149,1142,270,0,1561,1451,3012
2008,12,Resto de Europa,231,1069,928,4,2232,882,3114
2008,12,Estados Unidos,68,70,37,1,176,151,327
2008,12,Resto de América,24,44,32,2,102,88,190
2008,12,Resto del Mundo,132,178,20,8,338,170,508
2008,13,España,40644,176137,59762,1011,277554,99816,377370
2008,13,Holanda,5184,30364,9247,355,45150,29379,74529
2008,13,Bélgica,9077,36908,3750,164,49899,8441,58340
2008,13,Alemania,29573,139393,50936,275,220177,49099,269276
2008,13,Francia,3440,15202,4462,332,23436,22634,46070
2008,13,Gran Bretaña,49327,224523,65786,13233,352869,318391,671260
2008,13,Irlanda,3448,7243,795,41,11527,21570,33097
2008,13,Italia,2790,22568,5161,123,30642,10133,40775
2008,13,Suecia,918,20277,4263,35,25493,11225,36718
2008,13,Noruega,836,8933,5472,59,15300,9587,24887
2008,13,Dinamarca,550,11614,6329,6173,24666,19704,44370
2008,13,Finlandia,1127,5699,2771,160,9757,10793,20550
2008,13,Suiza,2287,5603,1650,98,9638,1935,11573
2008,13,Austria,2532,6214,993,4,9743,3073,12816
2008,13,Rusia,9054,17152,4295,300,30801,27879,58680
2008,13,Países del Este,3479,16821,4428,149,24877,19966,44843
2008,13,Resto de Europa,6536,20884,10674,35,38129,14111,52240
2008,13,Estados Unidos,812,866,149,32,1859,1575,3434
2008,13,Resto de América,419,792,263,60,1534,746,2280
2008,13,Resto del Mundo,2585,2226,208,65,5084,2608,7692
2009,1,España,1386,6879,4891,26,13182,3835,17017
2009,1,Holanda,371,1907,619,6,2903,1668,4571
2009,1,Bélgica,737,3854,454,8,5053,1157,6210
2009,1,Alemania,2514,10640,2936,16,16106,3627,19733
2009,1,Francia,278,1248,181,23,1730,1911,3641
2009,1,Gran Bretaña,2468,15383,3481,629,21961,21958,43919
2009,1,Irlanda,366,666,66,0,1098,2788,3886
2009,1,Italia,238,3224,286,6,3754,1153,4907
2009,1,Suecia,100,2902,500,2,3504,2635,6139
2009,1,Noruega,129,672,737,8,1546,1534,3080
2009,1,Dinamarca,77,1463,1084,510,3134,2898,6032
2009,1,Finlandia,127,995,400,4,1526,1677,3203
2009,1,Suiza,190,338,89,3,620,228,848
2009,1,Austria,264,606,128,4,1002,383,1385
2009,1,Rusia,525,1124,179,30,1858,2016,3874
2009,1,Países del Este,120,1139,203,7,1469,2556,4025
2009,1,Resto de Europa,123,946,756,0,1825,803,2628
2009,1,Estados Unidos,28,42,24,0,94,93,187
2009,1,Resto de América,18,139,17,0,174,89,263
2009,1,Resto del Mundo,575,120,8,0,703,93,796
2009,1,TOTAL,10634,54287,17039,1282,83242,53102,136344
2009,2,España,1311,5840,4697,6,11854,3414,15268
2009,2,Holanda,498,2432,642,28,3600,2203,5803
2009,2,Bélgica,727,3161,232,4,4124,614,4738
2009,2,Alemania,2409,9961,2846,22,15238,2502,17740
2009,2,Francia,332,1665,396,14,2407,2164,4571
2009,2,Gran Bretaña,4792,16644,3932,546,25914,21497,47411
2009,2,Irlanda,345,500,92,0,937,2871,3808
2009,2,Italia,245,2669,181,4,3099,903,4002
2009,2,Suecia,107,2517,524,4,3152,2624,5776
2009,2,Noruega,175,1111,765,3,2054,1751,3805
2009,2,Dinamarca,97,1442,835,571,2945,3267,6212
2009,2,Finlandia,118,1357,405,7,1887,1426,3313
2009,2,Suiza,188,534,71,2,795,191,986
2009,2,Austria,186,543,51,0,780,291,1071
2009,2,Rusia,150,513,270,3,936,928,1864
2009,2,Países del Este,101,996,216,26,1339,2259,3598
2009,2,Resto de Europa,199,925,813,2,1939,922,2861
2009,2,Estados Unidos,111,38,26,0,175,70,245
2009,2,Resto de América,27,138,2,0,167,52,219
2009,2,Resto del Mundo,247,177,15,0,439,62,501
2009,2,TOTAL,12365,53163,17011,1242,83781,50011,133792
2009,3,España,1442,5889,5351,7,12689,2817,15506
2009,3,Holanda,357,1815,650,43,2865,2113,4978
2009,3,Bélgica,831,2824,233,4,3892,595,4487
2009,3,Alemania,2456,10278,2975,34,15743,3196,18939
2009,3,Francia,274,1368,338,40,2020,1835,3855
2009,3,Gran Bretaña,3500,17148,4572,600,25820,21414,47234
2009,3,Irlanda,383,324,80,0,787,2808,3595
2009,3,Italia,197,2430,102,5,2734,547,3281
2009,3,Suecia,174,2936,440,17,3567,2888,6455
2009,3,Noruega,187,1408,733,0,2328,1864,4192
2009,3,Dinamarca,76,1633,1072,970,3751,2649,6400
2009,3,Finlandia,165,1153,554,0,1872,1759,3631
2009,3,Suiza,201,488,79,0,768,293,1061
2009,3,Austria,82,346,16,0,444,293,737
2009,3,Rusia,549,669,250,27,1495,1315,2810
2009,3,Países del Este,88,1362,221,8,1679,2398,4077
2009,3,Resto de Europa,127,969,740,1,1837,938,2775
2009,3,Estados Unidos,43,88,9,0,140,80,220
2009,3,Resto de América,19,61,12,0,92,69,161
2009,3,Resto del Mundo,434,154,16,4,608,69,677
2009,3,TOTAL,11585,53343,18443,1760,85131,49940,135071
2009,4,España,2084,12828,5214,102,20228,8576,28804
2009,4,Holanda,581,3063,735,47,4426,1845,6271
2009,4,Bélgica,1190,4710,248,8,6156,657,6813
2009,4,Alemania,2783,10479,4211,9,17482,2905,20387
2009,4,Francia,270,2372,609,35,3286,2130,5416
2009,4,Gran Bretaña,3905,16590,2427,726,23648,23544,47192
2009,4,Irlanda,333,444,77,3,857,2200,3057
2009,4,Italia,192,1705,207,20,2124,690,2814
2009,4,Suecia,98,1525,353,59,2035,1302,3337
2009,4,Noruega,90,568,247,4,909,477,1386
2009,4,Dinamarca,31,924,224,319,1498,811,2309
2009,4,Finlandia,86,501,273,0,860,726,1586
2009,4,Suiza,205,541,100,3,849,212,1061
2009,4,Austria,271,539,32,2,844,249,1093
2009,4,Rusia,343,831,298,20,1492,1472,2964
2009,4,Países del Este,166,1025,330,0,1521,2308,3829
2009,4,Resto de Europa,181,1009,635,0,1825,1331,3156
2009,4,Estados Unidos,79,120,11,0,210,212,422
2009,4,Resto de América,8,445,19,0,472,114,586
2009,4,Resto del Mundo,204,184,33,1,422,122,544
2009,4,TOTAL,13100,60403,16283,1358,91144,51883,143027
2009,5,España,2927,19380,6669,150,29126,6344,35470
2009,5,Holanda,387,2197,199,35,2818,1222,4040
2009,5,Bélgica,687,2325,74,12,3098,327,3425
2009,5,Alemania,1800,8563,3297,21,13681,1530,15211
2009,5,Francia,280,1141,282,10,1713,766,2479
2009,5,Gran Bretaña,3152,17964,1781,707,23604,20541,44145
2009,5,Irlanda,348,584,54,0,986,1874,2860
2009,5,Italia,130,1340,76,5,1551,489,2040
2009,5,Suecia,5,22,5,65,97,708,805
2009,5,Noruega,4,16,13,3,36,29,65
2009,5,Dinamarca,147,350,43,185,725,116,841
2009,5,Finlandia,3,112,6,0,121,37,158
2009,5,Suiza,166,466,105,2,739,178,917
2009,5,Austria,194,301,69,0,564,89,653
2009,5,Rusia,910,934,273,38,2155,2336,4491
2009,5,Países del Este,124,772,328,28,1252,2071,3323
2009,5,Resto de Europa,164,1060,151,25,1400,605,2005
2009,5,Estados Unidos,73,36,7,0,116,120,236
2009,5,Resto de América,29,87,13,0,129,75,204
2009,5,Resto del Mundo,293,117,12,2,424,93,517
2009,5,TOTAL,11823,57767,13457,1288,84335,39550,123885
2009,6,España,2861,16976,6060,95,25992,7149,33141
2009,6,Holanda,230,1635,194,8,2067,1037,3104
2009,6,Bélgica,505,2439,102,16,3062,274,3336
2009,6,Alemania,1572,9379,3619,17,14587,1186,15773
2009,6,Francia,164,823,186,5,1178,660,1838
2009,6,Gran Bretaña,2369,13741,1777,529,18416,22349,40765
2009,6,Irlanda,156,454,73,0,683,1542,2225
2009,6,Italia,159,1607,84,0,1850,666,2516
2009,6,Suecia,13,327,1,13,354,692,1046
2009,6,Noruega,2,229,3,13,247,162,409
2009,6,Dinamarca,8,529,7,332,876,112,988
2009,6,Finlandia,2,8,4,0,14,43,57
2009,6,Suiza,179,598,75,4,856,207,1063
2009,6,Austria,137,261,23,2,423,58,481
2009,6,Rusia,544,913,210,45,1712,1908,3620
2009,6,Países del Este,1098,1622,628,41,3389,2410,5799
2009,6,Resto de Europa,322,2532,706,3,3563,793,4356
2009,6,Estados Unidos,39,87,3,0,129,144,273
2009,6,Resto de América,22,77,23,3,125,54,179
2009,6,Resto del Mundo,250,60,9,0,319,99,418
2009,6,TOTAL,10632,54297,13787,1126,79842,41545,121387
2009,7,España,4581,24526,3642,498,33247,14574,47821
2009,7,Holanda,477,2337,1250,19,4083,2856,6939
2009,7,Bélgica,637,4126,103,12,4878,796,5674
2009,7,Alemania,1299,8382,5593,28,15302,2397,17699
2009,7,Francia,245,944,282,17,1488,1498,2986
2009,7,Gran Bretaña,2985,18642,1958,598,24183,21292,45475
2009,7,Irlanda,122,504,73,1,700,1573,2273
2009,7,Italia,120,1632,214,17,1983,948,2931
2009,7,Suecia,15,264,5,23,307,934,1241
2009,7,Noruega,6,341,11,10,368,368,736
2009,7,Dinamarca,16,372,78,282,748,167,915
2009,7,Finlandia,4,33,0,0,37,165,202
2009,7,Suiza,273,604,246,14,1137,316,1453
2009,7,Austria,133,425,46,0,604,211,815
2009,7,Rusia,750,899,407,26,2082,2119,4201
2009,7,Países del Este,324,1082,637,42,2085,2946,5031
2009,7,Resto de Europa,343,2718,876,14,3951,904,4855
2009,7,Estados Unidos,69,96,0,0,165,75,240
2009,7,Resto de América,35,156,32,3,226,114,340
2009,7,Resto del Mundo,192,137,11,9,349,156,505
2009,7,TOTAL,12626,68220,15464,1613,97923,54409,152332
2009,8,España,6478,30431,4915,493,42317,26182,68499
2009,8,Holanda,359,2383,1102,17,3861,2054,5915
2009,8,Bélgica,532,3954,154,3,4643,1064,5707
2009,8,Alemania,1198,8404,4384,12,13998,2544,16542
2009,8,Francia,251,1630,493,32,2406,2315,4721
2009,8,Gran Bretaña,2676,14384,2425,455,19940,22349,42289
2009,8,Irlanda,119,415,69,1,604,1897,2501
2009,8,Italia,220,3325,547,28,4120,2910,7030
2009,8,Suecia,3,317,1,8,329,89,418
2009,8,Noruega,11,157,1,0,169,18,187
2009,8,Dinamarca,1,258,81,253,593,87,680
2009,8,Finlandia,1,6,3,0,10,16,26
2009,8,Suiza,128,526,130,2,786,156,942
2009,8,Austria,71,353,21,0,445,129,574
2009,8,Rusia,721,973,217,42,1953,1715,3668
2009,8,Países del Este,284,1014,300,21,1619,1975,3594
2009,8,Resto de Europa,374,3533,342,7,4256,1239,5495
2009,8,Estados Unidos,79,92,12,3,186,123,309
2009,8,Resto de América,53,98,30,9,190,168,358
2009,8,Resto del Mundo,454,94,16,6,570,235,805
2009,8,TOTAL,14013,72347,15243,1392,102995,67265,170260
2009,9,España,3477,17753,2094,269,23593,11453,35046
2009,9,Holanda,319,1864,477,9,2669,1268,3937
2009,9,Bélgica,563,2751,81,15,3410,600,4010
2009,9,Alemania,1845,9348,3626,26,14845,2392,17237
2009,9,Francia,113,616,239,17,985,937,1922
2009,9,Gran Bretaña,2938,16051,2109,482,21580,19899,41479
2009,9,Irlanda,181,342,57,3,583,1239,1822
2009,9,Italia,82,1598,108,15,1803,587,2390
2009,9,Suecia,6,392,1,13,412,1102,1514
2009,9,Noruega,2,258,0,1,261,239,500
2009,9,Dinamarca,5,483,42,349,879,154,1033
2009,9,Finlandia,6,91,6,0,103,54,157
2009,9,Suiza,257,584,106,2,949,120,1069
2009,9,Austria,127,359,28,0,514,72,586
2009,9,Rusia,631,824,102,21,1578,1379,2957
2009,9,Países del Este,172,1121,521,43,1857,2623,4480
2009,9,Resto de Europa,333,2191,342,13,2879,752,3631
2009,9,Estados Unidos,54,72,3,3,132,80,212
2009,9,Resto de América,26,84,12,7,129,58,187
2009,9,Resto del Mundo,171,118,6,6,301,125,426
2009,9,TOTAL,11308,56900,9960,1294,79462,45133,124595
2009,10,España,2276,15875,3506,118,21775,6221,27996
2009,10,Holanda,477,2888,719,10,4094,1582,5676
2009,10,Bélgica,807,3040,114,15,3976,557,4533
2009,10,Alemania,2472,10243,3971,30,16716,3409,20125
2009,10,Francia,199,1300,206,21,1726,1672,3398
2009,10,Gran Bretaña,5065,21898,1972,645,29580,24869,54449
2009,10,Irlanda,282,612,65,5,964,1025,1989
2009,10,Italia,150,1469,90,4,1713,707,2420
2009,10,Suecia,135,1580,265,40,2020,2501,4521
2009,10,Noruega,89,587,194,23,893,712,1605
2009,10,Dinamarca,53,1332,205,248,1838,412,2250
2009,10,Finlandia,179,843,237,9,1268,1174,2442
2009,10,Suiza,203,778,171,17,1169,465,1634
2009,10,Austria,86,370,42,1,499,320,819
2009,10,Rusia,410,1093,127,30,1660,2204,3864
2009,10,Países del Este,173,1087,238,20,1518,2553,4071
2009,10,Resto de Europa,247,1393,368,1,2009,720,2729
2009,10,Estados Unidos,45,86,8,1,140,84,224
2009,10,Resto de América,34,90,8,9,141,84,225
2009,10,Resto del Mundo,191,116,2,6,315,73,388
2009,10,TOTAL,13573,66680,12508,1253,94014,51344,145358
2009,11,España,1328,8287,5777,70,15462,2905,18367
2009,11,Holanda,346,1786,462,41,2635,1312,3947
2009,11,Bélgica,1027,3834,258,5,5124,921,6045
2009,11,Alemania,2990,12091,2941,28,18050,3449,21499
2009,11,Francia,197,680,169,16,1062,1733,2795
2009,11,Gran Bretaña,3610,16854,1936,457,22857,21876,44733
2009,11,Irlanda,308,598,83,0,989,1372,2361
2009,11,Italia,112,1594,86,5,1797,370,2167
2009,11,Suecia,230,2388,807,53,3478,1935,5413
2009,11,Noruega,124,1486,673,34,2317,1727,4044
2009,11,Dinamarca,38,1497,183,437,2155,1480,3635
2009,11,Finlandia,220,1751,477,6,2454,1691,4145
2009,11,Suiza,301,491,103,14,909,300,1209
2009,11,Austria,203,797,74,0,1074,310,1384
2009,11,Rusia,340,813,130,23,1306,1470,2776
2009,11,Países del Este,122,1209,171,8,1510,1355,2865
2009,11,Resto de Europa,208,985,644,2,1839,1017,2856
2009,11,Estados Unidos,37,42,0,2,81,49,130
2009,11,Resto de América,21,82,5,1,109,57,166
2009,11,Resto del Mundo,195,70,13,15,293,77,370
2009,11,TOTAL,11957,57335,14992,1217,85501,45406,130907
2009,12,España,2373,11365,4931,63,18732,5306,24038
2009,12,Holanda,233,1891,338,14,2476,1534,4010
2009,12,Bélgica,876,3866,213,8,4963,1051,6014
2009,12,Alemania,2233,9893,2673,13,14812,3355,18167
2009,12,Francia,204,949,331,24,1508,1377,2885
2009,12,Gran Bretaña,3730,17975,2178,497,24380,21424,45804
2009,12,Irlanda,210,395,37,0,642,1242,1884
2009,12,Italia,223,1740,304,2,2269,763,3032
2009,12,Suecia,186,2009,529,131,2855,2485,5340
2009,12,Noruega,93,969,321,96,1479,1077,2556
2009,12,Dinamarca,14,1358,401,425,2198,1004,3202
2009,12,Finlandia,241,1322,324,16,1903,1616,3519
2009,12,Suiza,148,402,77,0,627,250,877
2009,12,Austria,117,548,52,0,717,444,1161
2009,12,Rusia,361,563,284,41,1249,1448,2697
2009,12,Países del Este,111,1564,153,21,1849,1649,3498
2009,12,Resto de Europa,129,1147,553,9,1838,618,2456
2009,12,Estados Unidos,75,71,6,4,156,100,256
2009,12,Resto de América,31,82,10,5,128,80,208
2009,12,Resto del Mundo,122,140,19,8,289,180,469
2009,12,TOTAL,11710,58249,13734,1377,85070,47003,132073
2009,13,España,32524,176029,57747,1897,268197,98776,366973
2009,13,Holanda,4635,26198,7387,277,38497,20694,59191
2009,13,Bélgica,9119,40884,2266,110,52379,8613,60992
2009,13,Alemania,25571,117661,43072,256,186560,32492,219052
2009,13,Francia,2807,14736,3712,254,21509,18998,40507
2009,13,Gran Bretaña,41190,203274,30548,6871,281883,263012,544895
2009,13,Irlanda,3153,5838,826,13,9830,22431,32261
2009,13,Italia,2068,24333,2285,111,28797,10733,39530
2009,13,Suecia,1072,17179,3431,428,22110,19895,42005
2009,13,Noruega,912,7802,3698,195,12607,9958,22565
2009,13,Dinamarca,563,11641,4255,4881,21340,13157,34497
2009,13,Finlandia,1152,8172,2689,42,12055,10384,22439
2009,13,Suiza,2439,6350,1352,63,10204,2916,13120
2009,13,Austria,1871,5448,582,9,7910,2849,10759
2009,13,Rusia,6234,10149,2747,346,19476,20310,39786
2009,13,Países del Este,2883,13993,3946,265,21087,27103,48190
2009,13,Resto de Europa,2750,19408,6926,77,29161,10642,39803
2009,13,Estados Unidos,732,870,109,13,1724,1230,2954
2009,13,Resto de América,323,1539,183,37,2082,1014,3096
2009,13,Resto del Mundo,3328,1487,160,57,5032,1384,6416
2009,13,TOTAL,145326,712991,177921,16202,1052440,596591,1649031
2010,1,España,1389,8145,4948,64,14546,3403,17949
2010,1,Holanda,288,1929,504,19,2740,1437,4177
2010,1,Bélgica,944,3674,452,14,5084,1093,6177
2010,1,Alemania,2403,11073,2553,10,16039,4008,20047
2010,1,Francia,167,1545,302,38,2052,1709,3761
2010,1,Gran Bretaña,3453,16404,1888,625,22370,19441,41811
2010,1,Irlanda,367,627,63,4,1061,1433,2494
2010,1,Italia,233,3216,265,17,3731,1374,5105
2010,1,Suecia,178,2733,426,82,3419,2581,6000
2010,1,Noruega,95,1228,524,106,1953,1082,3035
2010,1,Dinamarca,34,1571,790,499,2894,1766,4660
2010,1,Finlandia,174,1388,402,6,1970,1586,3556
2010,1,Suiza,190,395,73,5,663,282,945
2010,1,Austria,226,729,101,0,1056,481,1537
2010,1,Rusia,510,918,328,54,1810,1813,3623
2010,1,Países del Este,175,1037,191,9,1412,1900,3312
2010,1,Resto de Europa,215,1049,493,0,1757,683,2440
2010,1,Estados Unidos,75,50,6,0,131,53,184
2010,1,Resto de América,42,83,12,0,137,94,231
2010,1,Resto del Mundo,194,89,93,14,390,103,493
2010,1,TOTAL,11352,57883,14414,1566,85215,46322,131537
2010,2,España,1481,7793,4656,53,13983,3554,17537
2010,2,Holanda,405,2465,564,23,3457,1978,5435
2010,2,Bélgica,948,3388,232,9,4577,681,5258
2010,2,Alemania,2255,9752,2487,18,14512,3438,17950
2010,2,Francia,283,1858,401,27,2569,1791,4360
2010,2,Gran Bretaña,4607,16102,2127,512,23348,18812,42160
2010,2,Irlanda,392,536,38,0,966,1237,2203
2010,2,Italia,183,2480,136,2,2801,1096,3897
2010,2,Suecia,156,1952,356,66,2530,2037,4567
2010,2,Noruega,120,1182,391,68,1761,1160,2921
2010,2,Dinamarca,74,1631,591,381,2677,1936,4613
2010,2,Finlandia,213,1171,368,18,1770,1490,3260
2010,2,Suiza,215,447,88,4,754,201,955
2010,2,Austria,136,510,68,2,716,481,1197
2010,2,Rusia,320,343,188,43,894,1396,2290
2010,2,Países del Este,60,1781,181,14,2036,1221,3257
2010,2,Resto de Europa,207,1024,577,0,1808,709,2517
2010,2,Estados Unidos,65,64,6,1,136,50,186
2010,2,Resto de América,50,72,6,0,128,41,169
2010,2,Resto del Mundo,78,451,60,4,593,94,687
2010,2,TOTAL,12248,55002,13521,1245,82016,43403,125419
2010,3,España,2577,10146,5350,95,18168,6913,25081
2010,3,Holanda,369,2149,649,27,3194,1800,4994
2010,3,Bélgica,917,3021,164,7,4109,590,4699
2010,3,Alemania,2926,11055,3074,17,17072,3892,20964
2010,3,Francia,197,1485,226,35,1943,1276,3219
2010,3,Gran Bretaña,4762,17976,2245,468,25451,20840,46291
2010,3,Irlanda,392,638,53,3,1086,1376,2462
2010,3,Italia,198,2027,111,0,2336,930,3266
2010,3,Suecia,186,2140,435,86,2847,2158,5005
2010,3,Noruega,127,1192,338,35,1692,1228,2920
2010,3,Dinamarca,76,1757,597,413,2843,1682,4525
2010,3,Finlandia,178,1827,288,18,2311,1533,3844
2010,3,Suiza,227,379,170,0,776,342,1118
2010,3,Austria,150,505,73,0,728,454,1182
2010,3,Rusia,332,585,212,72,1201,1816,3017
2010,3,Países del Este,180,1348,228,5,1761,1750,3511
2010,3,Resto de Europa,254,1408,499,0,2161,859,3020
2010,3,Estados Unidos,68,150,11,0,229,114,343
2010,3,Resto de América,47,67,13,2,129,87,216
2010,3,Resto del Mundo,313,160,65,5,543,109,652
2010,3,TOTAL,14476,60015,14801,1288,90580,49749,140329
2010,4,España,2430,15096,6434,195,24155,11618,35773
2010,4,Holanda,442,2902,350,12,3706,1495,5201
2010,4,Bélgica,1238,5232,217,8,6695,757,7452
2010,4,Alemania,2091,10695,3288,17,16091,3443,19534
2010,4,Francia,336,2284,669,68,3357,1795,5152
2010,4,Gran Bretaña,5693,24383,2322,584,32982,23209,56191
2010,4,Irlanda,286,582,39,2,909,1413,2322
2010,4,Italia,175,1666,160,4,2005,533,2538
2010,4,Suecia,84,1123,222,88,1517,1403,2920
2010,4,Noruega,54,462,32,52,600,196,796
2010,4,Dinamarca,34,733,398,274,1439,593,2032
2010,4,Finlandia,68,428,45,1,542,786,1328
2010,4,Suiza,255,494,118,0,867,299,1166
2010,4,Austria,135,638,68,4,845,417,1262
2010,4,Rusia,344,1024,295,61,1724,2877,4601
2010,4,Países del Este,124,1369,236,3,1732,1754,3486
2010,4,Resto de Europa,166,1813,500,0,2479,831,3310
2010,4,Estados Unidos,88,130,14,0,232,151,383
2010,4,Resto de América,33,216,29,7,285,43,328
2010,4,Resto del Mundo,308,229,134,44,715,121,836
2010,4,TOTAL,14384,71499,15570,1424,102877,53734,156611
2010,5,España,3681,19097,8028,354,31160,9452,40612
2010,5,Holanda,478,3033,440,25,3976,1832,5808
2010,5,Bélgica,831,2755,95,3,3684,492,4176
2010,5,Alemania,1977,10550,3256,11,15794,2039,17833
2010,5,Francia,191,1120,266,18,1595,742,2337
2010,5,Gran Bretaña,4786,18632,1426,524,25368,17630,42998
2010,5,Irlanda,247,533,66,6,852,1219,2071
2010,5,Italia,201,1374,101,7,1683,607,2290
2010,5,Suecia,19,101,5,12,137,623,760
2010,5,Noruega,44,60,75,123,302,248,550
2010,5,Dinamarca,18,364,11,115,508,45,553
2010,5,Finlandia,5,7,4,5,21,45,66
2010,5,Suiza,236,502,42,0,780,150,930
2010,5,Austria,123,403,24,0,550,109,659
2010,5,Rusia,445,730,119,43,1337,2209,3546
2010,5,Países del Este,85,580,413,2,1080,1564,2644
2010,5,Resto de Europa,354,1620,327,2,2303,633,2936
2010,5,Estados Unidos,131,20,7,0,158,74,232
2010,5,Resto de América,30,119,17,0,166,82,248
2010,5,Resto del Mundo,261,885,7,33,1186,84,1270
2010,5,TOTAL,14143,62485,14729,1283,92640,39879,132519
2010,6,España,2508,17503,3852,371,24234,8958,33192
2010,6,Holanda,217,1339,287,1,1844,688,2532
2010,6,Bélgica,676,2913,110,25,3724,438,4162
2010,6,Alemania,1855,10094,3796,8,15753,1823,17576
2010,6,Francia,133,881,151,13,1178,733,1911
2010,6,Gran Bretaña,3609,18199,2405,450,24663,21191,45854
2010,6,Irlanda,172,539,80,6,797,1168,1965
2010,6,Italia,266,1597,103,7,1973,754,2727
2010,6,Suecia,5,241,47,10,303,810,1113
2010,6,Noruega,40,150,91,182,463,229,692
2010,6,Dinamarca,24,482,25,117,648,52,700
2010,6,Finlandia,5,8,6,0,19,84,103
2010,6,Suiza,187,377,93,0,657,149,806
2010,6,Austria,136,502,51,2,691,164,855
2010,6,Rusia,600,997,181,119,1897,2261,4158
2010,6,Países del Este,254,1704,582,9,2549,2282,4831
2010,6,Resto de Europa,218,2665,479,0,3362,616,3978
2010,6,Estados Unidos,90,62,1,2,155,114,269
2010,6,Resto de América,32,102,12,0,146,50,196
2010,6,Resto del Mundo,182,787,126,59,1154,123,1277
2010,6,TOTAL,11209,61142,12478,1381,86210,42687,128897
2010,7,España,5106,23924,4289,558,33877,13497,47374
2010,7,Holanda,387,2462,657,8,3514,2232,5746
2010,7,Bélgica,953,3960,105,11,5029,1212,6241
2010,7,Alemania,1398,10213,3666,14,15291,3229,18520
2010,7,Francia,199,1495,259,30,1983,2015,3998
2010,7,Gran Bretaña,4047,19175,2764,639,26625,23251,49876
2010,7,Irlanda,219,612,93,4,928,1218,2146
2010,7,Italia,97,1761,192,30,2080,1717,3797
2010,7,Suecia,39,239,69,6,353,906,1259
2010,7,Noruega,55,253,65,119,492,468,960
2010,7,Dinamarca,23,367,15,141,546,174,720
2010,7,Finlandia,6,2,2,1,11,110,121
2010,7,Suiza,230,764,143,0,1137,281,1418
2010,7,Austria,116,833,99,0,1048,291,1339
2010,7,Rusia,1024,1133,352,148,2657,3739,6396
2010,7,Países del Este,487,2213,365,12,3077,2646,5723
2010,7,Resto de Europa,225,2887,1077,0,4189,1362,5551
2010,7,Estados Unidos,84,80,1,1,166,157,323
2010,7,Resto de América,44,109,47,0,200,94,294
2010,7,Resto del Mundo,265,1022,56,39,1382,187,1569
2010,7,TOTAL,15004,73504,14316,1761,104585,58786,163371
2010,8,España,6638,27465,5531,502,40136,17949,58085
2010,8,Holanda,272,2394,680,29,3375,2273,5648
2010,8,Bélgica,564,3290,172,11,4037,1286,5323
2010,8,Alemania,1492,8513,4041,8,14054,3144,17198
2010,8,Francia,338,1450,305,27,2120,1561,3681
2010,8,Gran Bretaña,3932,18566,3320,369,26187,19285,45472
2010,8,Irlanda,102,474,112,4,692,1194,1886
2010,8,Italia,197,2943,461,35,3636,2248,5884
2010,8,Suecia,7,424,20,6,457,645,1102
2010,8,Noruega,13,242,64,293,612,148,760
2010,8,Dinamarca,4,306,29,131,470,62,532
2010,8,Finlandia,1,4,0,0,5,242,247
2010,8,Suiza,176,463,48,3,690,116,806
2010,8,Austria,130,459,71,3,663,203,866
2010,8,Rusia,774,1443,342,109,2668,2760,5428
2010,8,Países del Este,265,1563,379,0,2207,1677,3884
2010,8,Resto de Europa,460,3847,1266,0,5573,1479,7052
2010,8,Estados Unidos,53,43,18,0,114,90,204
2010,8,Resto de América,49,122,49,5,225,116,341
2010,8,Resto del Mundo,312,258,64,26,660,185,845
2010,8,TOTAL,15779,74269,16972,1561,108581,56663,165244
2010,9,España,3201,18960,3315,12,25488,10382,35870
2010,9,Holanda,367,1902,308,9,2586,1134,3720
2010,9,Bélgica,793,2849,186,4,3832,913,4745
2010,9,Alemania,2575,10439,3563,0,16577,2794,19371
2010,9,Francia,162,881,131,2,1176,902,2078
2010,9,Gran Bretaña,3617,16555,3040,583,23795,18298,42093
2010,9,Irlanda,197,423,119,0,739,941,1680
2010,9,Italia,89,1890,176,0,2155,755,2910
2010,9,Suecia,3,368,24,0,395,891,1286
2010,9,Noruega,30,216,34,0,280,211,491
2010,9,Dinamarca,9,376,15,0,400,105,505
2010,9,Finlandia,0,4,0,0,4,71,75
2010,9,Suiza,201,536,83,0,820,319,1139
2010,9,Austria,136,597,74,0,807,248,1055
2010,9,Rusia,581,1066,161,99,1907,2804,4711
2010,9,Países del Este,325,1455,406,2,2188,2546,4734
2010,9,Resto de Europa,266,2140,576,0,2982,1068,4050
2010,9,Estados Unidos,86,73,3,0,162,39,201
2010,9,Resto de América,12,94,48,0,154,92,246
2010,9,Resto del Mundo,155,1007,90,0,1252,163,1415
2010,9,TOTAL,12805,61831,12352,711,87699,44676,132375
2010,10,España,2935,15579,3122,178,21814,5661,27475
2010,10,Holanda,618,2771,623,102,4114,1543,5657
2010,10,Bélgica,1039,3119,187,2,4347,501,4848
2010,10,Alemania,3274,11022,3780,51,18127,3312,21439
2010,10,Francia,243,1675,358,37,2313,1792,4105
2010,10,Gran Bretaña,5836,26135,2514,42,34527,23776,58303
2010,10,Irlanda,220,717,120,4,1061,963,2024
2010,10,Italia,130,1043,137,12,1322,539,1861
2010,10,Suecia,141,2081,463,46,2731,1700,4431
2010,10,Noruega,93,936,189,52,1270,1074,2344
2010,10,Dinamarca,63,1216,64,280,1623,1278,2901
2010,10,Finlandia,219,1415,719,0,2353,970,3323
2010,10,Suiza,388,819,120,0,1327,346,1673
2010,10,Austria,214,597,23,0,834,171,1005
2010,10,Rusia,775,976,108,0,1859,3382,5241
2010,10,Países del Este,155,1071,350,0,1576,1924,3500
2010,10,Resto de Europa,296,1981,312,37,2626,784,3410
2010,10,Estados Unidos,68,118,2,0,188,59,247
2010,10,Resto de América,38,95,13,20,166,47,213
2010,10,Resto del Mundo,96,1077,81,0,1254,63,1317
2010,10,TOTAL,16841,74443,13285,863,105432,49885,155317
2010,11,España,932,6994,902,23,8851,4434,13285
2010,11,Holanda,509,2133,875,19,3536,1376,4912
2010,11,Bélgica,1290,3354,325,3,4972,966,5938
2010,11,Alemania,3852,12296,3767,12,19927,3134,23061
2010,11,Francia,300,843,359,38,1540,1617,3157
2010,11,Gran Bretaña,2853,19291,2380,416,24940,22920,47860
2010,11,Irlanda,198,577,78,0,853,1065,1918
2010,11,Italia,202,1228,148,16,1594,882,2476
2010,11,Suecia,121,3921,975,3,5020,2428,7448
2010,11,Noruega,110,1299,595,0,2004,1981,3985
2010,11,Dinamarca,72,1413,191,0,1676,1727,3403
2010,11,Finlandia,111,2202,1143,0,3456,1330,4786
2010,11,Suiza,395,612,72,0,1079,410,1489
2010,11,Austria,245,784,108,0,1137,492,1629
2010,11,Rusia,466,974,195,45,1680,2925,4605
2010,11,Países del Este,209,1770,198,0,2177,1445,3622
2010,11,Resto de Europa,204,1150,658,0,2012,1458,3470
2010,11,Estados Unidos,78,96,9,0,183,49,232
2010,11,Resto de América,35,41,16,0,92,51,143
2010,11,Resto del Mundo,76,338,67,0,481,40,521
2010,11,TOTAL,12258,61316,13061,575,87210,50730,137940
2010,12,España,1967,11023,5461,19,18470,4405,22875
2010,12,Holanda,357,2026,484,14,2881,2339,5220
2010,12,Bélgica,841,3429,208,19,4497,990,5487
2010,12,Alemania,2483,11608,2581,9,16681,3405,20086
2010,12,Francia,342,1330,650,19,2341,1524,3865
2010,12,Gran Bretaña,4699,16755,2289,900,24643,25387,50030
2010,12,Irlanda,156,516,72,2,746,780,1526
2010,12,Italia,246,2119,235,17,2617,966,3583
2010,12,Suecia,198,3114,332,13,3657,1989,5646
2010,12,Noruega,106,1162,212,8,1488,1214,2702
2010,12,Dinamarca,41,1200,192,3,1436,1431,2867
2010,12,Finlandia,286,1815,474,8,2583,1609,4192
2010,12,Suiza,148,417,38,3,606,184,790
2010,12,Austria,207,533,48,0,788,207,995
2010,12,Rusia,627,717,107,98,1549,2487,4036
2010,12,Países del Este,216,1372,86,2,1676,1329,3005
2010,12,Resto de Europa,324,1135,590,0,2049,1435,3484
2010,12,Estados Unidos,81,92,11,0,184,60,244
2010,12,Resto de América,34,77,12,0,123,54,177
2010,12,Resto del Mundo,219,648,71,2,940,134,1074
2010,12,TOTAL,13578,61088,14153,1136,89955,51929,141884
2010,13,España,34845,181725,55888,2429,274882,100226,375108
2010,13,Holanda,4709,27505,6421,296,38923,20127,59050
2010,13,Bélgica,11034,40984,2453,117,54587,9919,64506
2010,13,Alemania,28581,127310,39852,174,195918,37661,233579
2010,13,Francia,2891,16847,4077,367,24167,17457,41624
2010,13,Gran Bretaña,51894,228173,28720,5787,314899,254040,568939
2010,13,Irlanda,2948,6774,933,37,10690,14007,24697
2010,13,Italia,2217,23344,2225,132,27933,12401,40334
2010,13,Suecia,1137,18437,3374,409,23366,18171,41537
2010,13,Noruega,887,8382,2610,1034,12917,9239,22156
2010,13,Dinamarca,472,11416,2918,2357,17160,10851,28011
2010,13,Finlandia,1266,10271,3451,49,15045,9856,24901
2010,13,Suiza,2848,6205,1088,18,10156,3079,13235
2010,13,Austria,1954,7090,808,11,9863,3718,13581
2010,13,Rusia,6798,10906,2588,884,21183,30469,51652
2010,13,Países del Este,2535,17263,3615,56,23471,22038,45509
2010,13,Resto de Europa,3189,22719,7354,39,33301,11917,45218
2010,13,Estados Unidos,967,978,89,4,2038,1010,3048
2010,13,Resto de América,446,1197,274,34,1951,851,2802
2010,13,Resto del Mundo,2459,6951,914,228,10550,1406,11956
2010,13,TOTAL,164077,774477,169652,14462,1123000,588443,1711443
2011,1,España,899,7097,4715,10,12721,2639,15360
2011,1,Holanda,342,2145,645,2,3134,1543,4677
2011,1,Bélgica,1255,4032,399,8,5694,1099,6793
2011,1,Alemania,2350,12688,2629,13,17680,3142,20822
2011,1,Francia,465,2066,377,4,2912,1896,4808
2011,1,Gran Bretaña,4835,15306,1837,761,22739,16386,39125
2011,1,Irlanda,289,512,138,2,941,942,1883
2011,1,Italia,277,4014,378,3,4672,1473,6145
2011,1,Suecia,170,4393,693,14,5270,2764,8034
2011,1,Noruega,111,1375,384,4,1874,1587,3461
2011,1,Dinamarca,66,1912,761,2,2741,1536,4277
2011,1,Finlandia,198,1800,713,5,2716,2890,5606
2011,1,Suiza,208,417,77,0,702,366,1068
2011,1,Austria,251,680,77,0,1008,471,1479
2011,1,Rusia,539,1263,180,108,2090,2457,4547
2011,1,Países del Este,153,1535,194,2,1884,1757,3641
2011,1,Resto de Europa,110,1336,310,0,1756,443,2199
2011,1,Estados Unidos,139,69,7,4,219,65,284
2011,1,Resto de América,54,64,9,2,129,42,171
2011,1,Resto del Mundo,95,312,65,0,472,76,548
2011,1,TOTAL,12806,63016,14588,944,91354,43574,134928
2011,2,España,1399,6619,4395,2,12415,2086,14501
2011,2,Holanda,415,3206,750,15,4386,2995,7381
2011,2,Bélgica,1124,4028,214,12,5378,812,6190
2011,2,Alemania,2444,10206,3065,16,15731,3412,19143
2011,2,Francia,594,3872,752,25,5243,2268,7511
2011,2,Gran Bretaña,5491,16849,1887,717,24944,23059,48003
2011,2,Irlanda,352,640,40,0,1032,920,1952
2011,2,Italia,228,4182,224,7,4641,1284,5925
2011,2,Suecia,208,4151,612,6,4977,2505,7482
2011,2,Noruega,172,1782,658,5,2617,1324,3941
2011,2,Dinamarca,108,2245,785,3,3141,1961,5102
2011,2,Finlandia,256,2507,724,8,3495,2483,5978
2011,2,Suiza,231,567,65,3,866,237,1103
2011,2,Austria,271,861,99,0,1231,220,1451
2011,2,Rusia,183,465,174,48,870,1413,2283
2011,2,Países del Este,150,1507,150,10,1817,990,2807
2011,2,Resto de Europa,307,1835,586,7,2735,979,3714
2011,2,Estados Unidos,114,133,8,0,255,68,323
2011,2,Resto de América,28,72,8,0,108,57,165
2011,2,Resto del Mundo,44,402,9,1,456,133,589
2011,2,TOTAL,14119,66129,15205,885,96338,49206,145544
2011,3,España,1653,6944,5170,2,13769,3156,16925
2011,3,Holanda,584,3339,1106,2,5031,2875,7906
2011,3,Bélgica,1333,4547,224,7,6111,677,6788
2011,3,Alemania,3260,11323,2997,7,17587,3575,21162
2011,3,Francia,330,3336,769,0,4435,2158,6593
2011,3,Gran Bretaña,5163,20730,2050,867,28810,24341,53151
2011,3,Irlanda,269,416,31,0,716,1084,1800
2011,3,Italia,312,3407,311,5,4035,757,4792
2011,3,Suecia,265,4616,799,7,5687,3375,9062
2011,3,Noruega,210,1941,641,2,2794,1509,4303
2011,3,Dinamarca,182,2211,853,7,3253,2242,5495
2011,3,Finlandia,501,2541,828,8,3878,2131,6009
2011,3,Suiza,294,724,95,0,1113,216,1329
2011,3,Austria,206,701,53,0,960,135,1095
2011,3,Rusia,499,1081,187,111,1878,2411,4289
2011,3,Países del Este,195,2089,100,10,2394,1700,4094
2011,3,Resto de Europa,280,1696,693,0,2669,1400,4069
2011,3,Estados Unidos,207,100,9,2,318,147,465
2011,3,Resto de América,67,41,85,2,195,76,271
2011,3,Resto del Mundo,209,293,10,2,514,141,655
2011,3,TOTAL,16019,72076,17011,1041,106147,54106,160253
2011,4,España,2169,14210,5799,34,22212,7973,30185
2011,4,Holanda,488,3198,728,22,4436,2151,6587
2011,4,Bélgica,1411,4835,153,0,6399,784,7183
2011,4,Alemania,2966,12170,3531,8,18675,3854,22529
2011,4,Francia,591,4535,986,7,6119,2520,8639
2011,4,Gran Bretaña,6457,20663,2291,950,30361,26422,56783
2011,4,Irlanda,220,465,85,0,770,1001,1771
2011,4,Italia,408,3662,223,6,4299,685,4984
2011,4,Suecia,195,3031,416,2,3644,1239,4883
2011,4,Noruega,123,1251,272,6,1652,765,2417
2011,4,Dinamarca,65,1756,596,7,2424,1393,3817
2011,4,Finlandia,159,807,227,12,1205,1079,2284
2011,4,Suiza,419,907,180,0,1506,303,1809
2011,4,Austria,285,796,63,0,1144,292,1436
2011,4,Rusia,660,1859,212,139,2870,2377,5247
2011,4,Países del Este,245,3805,280,2,4332,2398,6730
2011,4,Resto de Europa,474,1865,541,5,2885,789,3674
2011,4,Estados Unidos,157,194,5,12,368,178,546
2011,4,Resto de América,50,98,30,2,180,82,262
2011,4,Resto del Mundo,149,463,94,0,706,143,849
2011,4,TOTAL,17691,80570,16712,1214,116187,56428,172615
2011,5,España,2070,14317,5934,17,22338,7020,29358
2011,5,Holanda,447,2364,601,0,3412,1180,4592
2011,5,Bélgica,761,2662,89,6,3518,410,3928
2011,5,Alemania,2190,9529,3463,16,15198,1718,16916
2011,5,Francia,384,2229,422,8,3043,805,3848
2011,5,Gran Bretaña,5147,21000,2145,702,28994,20032,49026
2011,5,Irlanda,162,568,89,0,819,1299,2118
2011,5,Italia,254,2645,159,8,3066,470,3536
2011,5,Suecia,23,128,14,5,170,57,227
2011,5,Noruega,26,61,54,2,143,309,452
2011,5,Dinamarca,8,509,10,2,529,258,787
2011,5,Finlandia,4,109,0,0,113,20,133
2011,5,Suiza,402,674,321,0,1397,262,1659
2011,5,Austria,237,521,47,0,805,150,955
2011,5,Rusia,471,1577,151,43,2242,2465,4707
2011,5,Países del Este,334,1074,188,8,1604,1888,3492
2011,5,Resto de Europa,306,1063,352,0,1721,474,2195
2011,5,Estados Unidos,91,91,5,2,189,104,293
2011,5,Resto de América,26,112,16,0,154,60,214
2011,5,Resto del Mundo,126,767,53,0,946,93,1039
2011,5,TOTAL,13469,62000,14113,819,90401,39074,129475
2011,6,España,1852,5382,2987,187,10408,9308,19716
2011,6,Holanda,127,1299,206,23,1655,2219,3874
2011,6,Bélgica,293,3019,176,11,3499,588,4087
2011,6,Alemania,383,2186,1839,80,4488,1608,6096
2011,6,Francia,244,601,199,367,1411,1890,3301
2011,6,Gran Bretaña,1698,11909,6931,156,20694,38492,59186
2011,6,Irlanda,221,659,591,7,1478,2777,4255
2011,6,Italia,170,1034,614,39,1857,858,2715
2011,6,Suecia,12,34,37,2,85,177,262
2011,6,Noruega,170,23,89,0,282,319,601
2011,6,Dinamarca,52,96,107,2,257,621,878
2011,6,Finlandia,0,12,10,0,22,49,71
2011,6,Suiza,52,312,48,4,416,255,671
2011,6,Austria,39,293,55,0,387,202,589
2011,6,Rusia,817,791,193,0,1801,996,2797
2011,6,Países del Este,127,467,338,122,1054,617,1671
2011,6,Resto de Europa,293,771,466,3,1533,1039,2572
2011,6,Estados Unidos,45,53,34,4,136,189,325
2011,6,Resto de América,36,37,35,29,137,232,369
2011,6,Resto del Mundo,225,1805,14,15,2059,450,2509
2011,6,TOTAL,6856,30783,14969,1051,53659,62886,116545
2011,7,España,4551,23825,3571,540,32487,15642,48129
2011,7,Holanda,353,3050,1437,17,4857,2117,6974
2011,7,Bélgica,1005,5041,267,15,6328,866,7194
2011,7,Alemania,1419,9668,5033,27,16147,4015,20162
2011,7,Francia,388,2007,524,48,2967,1387,4354
2011,7,Gran Bretaña,5233,21510,4207,794,31744,27500,59244
2011,7,Irlanda,226,636,85,13,960,1581,2541
2011,7,Italia,85,2800,321,28,3234,1082,4316
2011,7,Suecia,36,241,66,6,349,136,485
2011,7,Noruega,20,286,35,37,378,216,594
2011,7,Dinamarca,53,503,42,230,828,261,1089
2011,7,Finlandia,0,2,4,0,6,6,12
2011,7,Suiza,360,1209,335,1,1905,437,2342
2011,7,Austria,181,905,98,2,1186,299,1485
2011,7,Rusia,984,2841,373,215,4413,2461,6874
2011,7,Países del Este,268,2652,465,53,3438,1994,5432
2011,7,Resto de Europa,358,2419,890,17,3684,1100,4784
2011,7,Estados Unidos,119,110,14,6,249,78,327
2011,7,Resto de América,49,133,45,21,248,114,362
2011,7,Resto del Mundo,187,1345,15,2,1549,216,1765
2011,7,TOTAL,15875,81183,17827,2072,116957,61508,178465
2011,8,España,5545,24332,3585,458,33920,15738,49658
2011,8,Holanda,371,2456,1511,13,4351,1191,5542
2011,8,Bélgica,611,4090,135,8,4844,606,5450
2011,8,Alemania,1720,9393,6026,25,17164,2924,20088
2011,8,Francia,439,1827,399,40,2705,1353,4058
2011,8,Gran Bretaña,4116,20364,5747,652,30879,24682,55561
2011,8,Irlanda,106,507,150,2,765,1353,2118
2011,8,Italia,316,2644,738,53,3751,2178,5929
2011,8,Suecia,4,480,2,10,496,11,507
2011,8,Noruega,3,358,0,109,470,214,684
2011,8,Dinamarca,28,393,17,258,696,233,929
2011,8,Finlandia,0,4,0,0,4,2,6
2011,8,Suiza,285,878,166,4,1333,173,1506
2011,8,Austria,164,662,17,4,847,127,974
2011,8,Rusia,1001,2292,301,137,3731,1586,5317
2011,8,Países del Este,397,1519,270,31,2217,1729,3946
2011,8,Resto de Europa,235,2706,601,14,3556,1111,4667
2011,8,Estados Unidos,94,66,2,0,162,78,240
2011,8,Resto de América,26,96,68,10,200,127,327
2011,8,Resto del Mundo,166,1154,2,7,1329,127,1456
2011,8,TOTAL,15627,76221,19737,1835,113420,55543,168963
2011,9,España,3211,16031,2063,263,21568,10813,32381
2011,9,Holanda,499,2228,659,22,3408,1292,4700
2011,9,Bélgica,865,3766,102,14,4747,655,5402
2011,9,Alemania,2518,10889,5007,28,18442,2209,20651
2011,9,Francia,184,1009,186,28,1407,1264,2671
2011,9,Gran Bretaña,4419,23495,5736,825,34475,22794,57269
2011,9,Irlanda,258,529,117,2,906,949,1855
2011,9,Italia,129,2631,313,13,3086,895,3981
2011,9,Suecia,10,392,58,4,464,45,509
2011,9,Noruega,31,258,29,153,471,249,720
2011,9,Dinamarca,25,379,12,204,620,270,890
2011,9,Finlandia,6,157,0,2,165,43,208
2011,9,Suiza,372,694,286,1,1353,212,1565
2011,9,Austria,147,567,71,2,787,116,903
2011,9,Rusia,907,2036,317,133,3393,2123,5516
2011,9,Países del Este,387,2068,576,52,3083,2436,5519
2011,9,Resto de Europa,302,1936,1026,8,3272,1047,4319
2011,9,Estados Unidos,77,38,0,7,122,77,199
2011,9,Resto de América,42,76,29,11,158,116,274
2011,9,Resto del Mundo,355,1088,8,16,1467,165,1632
2011,9,TOTAL,14744,70267,16595,1788,103394,47770,151164
2011,10,España,1786,12818,1345,122,16071,7508,23579
2011,10,Holanda,634,3261,986,18,4899,2275,7174
2011,10,Bélgica,1138,4027,135,4,5304,541,5845
2011,10,Alemania,3435,13836,5292,8,22571,3015,25586
2011,10,Francia,326,1897,297,24,2544,1958,4502
2011,10,Gran Bretaña,6191,25992,4495,629,37307,24785,62092
2011,10,Irlanda,296,678,176,2,1152,1137,2289
2011,10,Italia,140,1572,204,14,1930,919,2849
2011,10,Suecia,137,2501,400,83,3121,1155,4276
2011,10,Noruega,196,1333,372,86,1987,1757,3744
2011,10,Dinamarca,93,1260,138,365,1856,763,2619
2011,10,Finlandia,165,1744,732,15,2656,1302,3958
2011,10,Suiza,680,1739,225,3,2647,583,3230
2011,10,Austria,263,744,58,0,1065,116,1181
2011,10,Rusia,637,1838,253,106,2834,2594,5428
2011,10,Países del Este,467,2397,548,55,3467,2748,6215
2011,10,Resto de Europa,303,1370,721,0,2394,1352,3746
2011,10,Estados Unidos,91,84,11,0,186,77,263
2011,10,Resto de América,62,86,39,5,192,54,246
2011,10,Resto del Mundo,324,436,6,4,770,326,1096
2011,10,TOTAL,17364,79613,16433,1543,114953,54965,169918
2011,11,España,896,6063,5221,31,12211,4048,16259
2011,11,Holanda,510,2376,639,27,3552,1706,5258
2011,11,Bélgica,1038,3798,293,16,5145,835,5980
2011,11,Alemania,3340,14382,2046,26,19794,3117,22911
2011,11,Francia,263,1101,364,38,1766,1502,3268
2011,11,Gran Bretaña,4522,19839,2507,608,27476,20983,48459
2011,11,Irlanda,234,603,59,0,896,820,1716
2011,11,Italia,136,1408,148,12,1704,594,2298
2011,11,Suecia,268,4229,823,27,5347,2287,7634
2011,11,Noruega,200,1843,475,27,2545,1732,4277
2011,11,Dinamarca,65,1423,177,571,2236,1781,4017
2011,11,Finlandia,472,2112,716,4,3304,1657,4961
2011,11,Suiza,432,866,74,5,1377,309,1686
2011,11,Austria,244,1085,92,0,1421,181,1602
2011,11,Rusia,501,1579,297,82,2459,2474,4933
2011,11,Países del Este,256,2093,333,9,2691,1845,4536
2011,11,Resto de Europa,259,1060,733,2,2054,1303,3357
2011,11,Estados Unidos,52,112,12,0,176,62,238
2011,11,Resto de América,25,116,9,2,152,40,192
2011,11,Resto del Mundo,134,360,45,0,539,258,797
2011,11,TOTAL,13847,66448,15063,1487,96845,47534,144379
2011,12,España,2265,9133,5919,31,17348,5240,22588
2011,12,Holanda,322,2118,607,17,3064,1761,4825
2011,12,Bélgica,1039,3823,248,16,5126,941,6067
2011,12,Alemania,2598,10866,1701,20,15185,3164,18349
2011,12,Francia,369,1703,509,31,2612,2052,4664
2011,12,Gran Bretaña,4926,19427,2700,880,27933,24479,52412
2011,12,Irlanda,203,532,54,0,789,795,1584
2011,12,Italia,123,1637,290,14,2064,1360,3424
2011,12,Suecia,349,3986,581,22,4938,2138,7076
2011,12,Noruega,135,1407,317,52,1911,1230,3141
2011,12,Dinamarca,50,1238,514,553,2355,1772,4127
2011,12,Finlandia,418,2033,495,14,2960,1951,4911
2011,12,Suiza,318,588,79,11,996,218,1214
2011,12,Austria,214,572,153,0,939,211,1150
2011,12,Rusia,510,1801,366,137,2814,3521,6335
2011,12,Países del Este,352,2015,556,18,2941,2087,5028
2011,12,Resto de Europa,546,1090,668,12,2316,964,3280
2011,12,Estados Unidos,140,71,4,4,219,95,314
2011,12,Resto de América,57,101,32,3,193,197,390
2011,12,Resto del Mundo,277,589,50,4,920,146,1066
2011,12,TOTAL,15211,64730,15843,1839,97623,54322,151945
2011,13,España,29234,158517,51596,1847,241194,90057,331251
2011,13,Holanda,5254,31702,9941,161,47058,21892,68950
2011,13,Bélgica,12251,47872,2369,117,62609,8602,71211
2011,13,Alemania,30804,136547,44323,240,211914,36602,248516
2011,13,Francia,4615,26884,5771,297,37567,19772,57339
2011,13,Gran Bretaña,60511,246116,38170,9108,353905,280730,634635
2011,13,Irlanda,2805,6610,1067,22,10504,13451,23955
2011,13,Italia,2521,32657,3418,181,38777,12459,51236
2011,13,Suecia,1670,28192,4488,198,34548,15775,50323
2011,13,Noruega,1236,11954,3276,617,17083,11107,28190
2011,13,Dinamarca,762,13903,3920,2385,20970,12670,33640
2011,13,Finlandia,2185,13828,4441,68,20522,13579,34101
2011,13,Suiza,4329,9793,2065,28,16215,3520,19735
2011,13,Austria,2648,8548,869,8,12073,2391,14464
2011,13,Rusia,7433,20892,2971,1409,32705,28282,60987
2011,13,Países del Este,3508,24458,3915,309,32190,23611,55801
2011,13,Resto de Europa,3672,20321,7827,76,31896,11947,43843
2011,13,Estados Unidos,1346,1198,87,38,2669,1117,3786
2011,13,Resto de América,519,1087,387,90,2083,1076,3159
2011,13,Resto del Mundo,2183,8054,404,43,10684,1949,12633
2011,13,TOTAL,179486,849133,191305,17242,1237166,610589,1847755
2012,1,España,1697,6503,5741,31,13972,3076,17048
2012,1,Holanda,669,2487,645,12,3813,1153,4966
2012,1,Bélgica,1315,3743,450,20,5528,1044,6572
2012,1,Alemania,3824,12858,1623,30,18335,2681,21016
2012,1,Francia,503,2022,314,21,2860,1316,4176
2012,1,Gran Bretaña,5035,18525,1839,635,26034,18279,44313
2012,1,Irlanda,362,842,61,1,1266,892,2158
2012,1,Italia,442,2903,274,10,3629,1176,4805
2012,1,Suecia,369,5603,685,44,6701,2354,9055
2012,1,Noruega,435,2115,270,54,2874,1394,4268
2012,1,Dinamarca,104,1982,770,672,3528,1778,5306
2012,1,Finlandia,381,1934,512,9,2836,1482,4318
2012,1,Suiza,434,545,88,2,1069,105,1174
2012,1,Austria,302,770,86,0,1158,185,1343
2012,1,Rusia,956,2040,318,184,3498,2385,5883
2012,1,Países del Este,255,2835,426,5,3521,1655,5176
2012,1,Resto de Europa,430,899,403,4,1736,981,2717
2012,1,Estados Unidos,73,106,4,3,186,64,250
2012,1,Resto de América,61,118,8,0,187,107,294
2012,1,Resto del Mundo,163,462,17,10,652,150,802
2012,1,TOTAL,17810,69292,14534,1747,103383,42257,145640
2012,2,España,1091,4474,4912,38,10515,3929,14444
2012,2,Holanda,822,2913,645,24,4404,1973,6377
2012,2,Bélgica,1383,4864,211,14,6472,907,7379
2012,2,Alemania,3362,10997,2985,26,17370,2574,19944
2012,2,Francia,447,2577,443,41,3508,2551,6059
2012,2,Gran Bretaña,5769,18977,2108,705,27559,18595,46154
2012,2,Irlanda,255,565,47,0,867,731,1598
2012,2,Italia,202,1992,142,7,2343,1013,3356
2012,2,Suecia,418,4451,452,45,5366,1186,6552
2012,2,Noruega,453,2177,430,41,3101,1308,4409
2012,2,Dinamarca,112,2287,679,523,3601,2312,5913
2012,2,Finlandia,535,2052,402,18,3007,1982,4989
2012,2,Suiza,439,536,215,0,1190,92,1282
2012,2,Austria,353,822,62,6,1243,193,1436
2012,2,Rusia,324,687,124,84,1219,1918,3137
2012,2,Países del Este,444,1673,194,13,2324,1023,3347
2012,2,Resto de Europa,328,981,411,2,1722,955,2677
2012,2,Estados Unidos,71,126,2,3,202,54,256
2012,2,Resto de América,29,96,23,7,155,47,202
2012,2,Resto del Mundo,344,317,18,7,686,47,733
2012,2,TOTAL,17181,63564,14505,1604,96854,43390,140244
2012,3,España,1327,6178,4815,58,12378,4993,17371
2012,3,Holanda,779,2410,649,19,3857,1726,5583
2012,3,Bélgica,1118,4202,242,18,5580,772,6352
2012,3,Alemania,4003,11554,3370,33,18960,3108,22068
2012,3,Francia,491,2604,444,23,3562,2513,6075
2012,3,Gran Bretaña,7015,22410,2933,974,33332,20035,53367
2012,3,Irlanda,326,491,68,0,885,793,1678
2012,3,Italia,213,1641,142,7,2003,757,2760
2012,3,Suecia,448,4853,855,39,6195,2325,8520
2012,3,Noruega,200,2031,570,29,2830,1646,4476
2012,3,Dinamarca,69,1948,843,474,3334,2342,5676
2012,3,Finlandia,452,2507,537,10,3506,1971,5477
2012,3,Suiza,387,534,113,3,1037,135,1172
2012,3,Austria,355,701,105,3,1164,289,1453
2012,3,Rusia,533,1381,300,136,2350,3135,5485
2012,3,Países del Este,312,1910,372,28,2622,1710,4332
2012,3,Resto de Europa,224,1317,528,2,2071,1219,3290
2012,3,Estados Unidos,91,79,9,0,179,100,279
2012,3,Resto de América,39,105,36,1,181,105,286
2012,3,Resto del Mundo,115,337,4,2,458,106,564
2012,3,TOTAL,18497,69193,16935,1859,106484,49780,156264
2012,4,España,2494,12202,6838,269,21803,9090,30893
2012,4,Holanda,497,3427,594,23,4541,1246,5787
2012,4,Bélgica,1262,4255,176,23,5716,563,6279
2012,4,Alemania,3445,11082,3351,14,17892,2477,20369
2012,4,Francia,629,4520,683,63,5895,2433,8328
2012,4,Gran Bretaña,6485,21650,1833,692,30660,18148,48808
2012,4,Irlanda,185,572,53,4,814,746,1560
2012,4,Italia,278,1814,106,18,2216,810,3026
2012,4,Suecia,255,1905,344,75,2579,1128,3707
2012,4,Noruega,168,1083,256,77,1584,859,2443
2012,4,Dinamarca,33,1218,165,229,1645,624,2269
2012,4,Finlandia,98,840,139,5,1082,492,1574
2012,4,Suiza,610,802,113,6,1531,264,1795
2012,4,Austria,253,443,110,6,812,203,1015
2012,4,Rusia,1038,2123,260,175,3596,2952,6548
2012,4,Países del Este,328,2497,369,58,3252,1628,4880
2012,4,Resto de Europa,265,1115,446,4,1830,932,2762
2012,4,Estados Unidos,267,193,24,2,486,115,601
2012,4,Resto de América,43,131,18,13,205,85,290
2012,4,Resto del Mundo,297,462,10,9,778,184,962
2012,4,TOTAL,18930,72334,15888,1765,108917,44979,153896
2012,5,España,1745,11068,5858,208,18879,6046,24925
2012,5,Holanda,400,2055,311,9,2775,1189,3964
2012,5,Bélgica,887,2859,110,42,3898,288,4186
2012,5,Alemania,2949,9063,2945,19,14976,2332,17308
2012,5,Francia,435,2328,364,29,3156,822,3978
2012,5,Gran Bretaña,5770,21086,1689,613,29158,17132,46290
2012,5,Irlanda,269,572,48,0,889,766,1655
2012,5,Italia,518,1364,78,15,1975,522,2497
2012,5,Suecia,12,110,33,2,157,375,532
2012,5,Noruega,40,67,26,51,184,190,374
2012,5,Dinamarca,15,477,30,147,669,256,925
2012,5,Finlandia,2,173,4,0,179,150,329
2012,5,Suiza,543,498,88,1,1130,301,1431
2012,5,Austria,250,386,65,6,707,57,764
2012,5,Rusia,880,2132,132,134,3278,2657,5935
2012,5,Países del Este,459,7471,521,61,8512,1940,10452
2012,5,Resto de Europa,455,1246,247,2,1950,997,2947
2012,5,Estados Unidos,104,68,1,0,173,72,245
2012,5,Resto de América,32,59,15,9,115,66,181
2012,5,Resto del Mundo,106,281,65,12,464,1204,1668
2012,5,TOTAL,15871,63363,12630,1360,93224,37362,130586
2012,6,España,2379,14329,6799,334,23841,7780,31621
2012,6,Holanda,272,1850,545,9,2676,909,3585
2012,6,Bélgica,716,3109,269,13,4107,463,4570
2012,6,Alemania,2680,10097,2185,24,14986,2136,17122
2012,6,Francia,356,1027,418,20,1821,903,2724
2012,6,Gran Bretaña,6099,23211,2427,878,32615,18512,51127
2012,6,Irlanda,203,559,111,6,879,1094,1973
2012,6,Italia,163,1383,203,18,1767,733,2500
2012,6,Suecia,14,215,13,4,246,316,562
2012,6,Noruega,18,62,93,61,234,266,500
2012,6,Dinamarca,10,372,33,206,621,137,758
2012,6,Finlandia,4,14,0,0,18,72,90
2012,6,Suiza,492,674,194,8,1368,209,1577
2012,6,Austria,370,633,121,0,1124,111,1235
2012,6,Rusia,1081,3235,271,267,4854,4656,9510
2012,6,Países del Este,214,2491,840,48,3593,2065,5658
2012,6,Resto de Europa,507,1935,563,10,3015,635,3650
2012,6,Estados Unidos,141,77,3,4,225,137,362
2012,6,Resto de América,70,89,74,21,254,100,354
2012,6,Resto del Mundo,218,119,68,17,422,202,624
2012,6,TOTAL,16007,65481,15230,1948,98666,41436,140102
2012,7,España,4350,15746,4925,10,25031,10760,35791
2012,7,Holanda,725,4026,1678,12,6441,2394,8835
2012,7,Bélgica,1291,3248,485,13,5037,624,5661
2012,7,Alemania,2485,9289,3274,6,15054,2766,17820
2012,7,Francia,507,1719,387,8,2621,1857,4478
2012,7,Gran Bretaña,6083,19153,4106,767,30109,20516,50625
2012,7,Irlanda,156,387,94,0,637,1436,2073
2012,7,Italia,155,2254,314,0,2723,958,3681
2012,7,Suecia,35,320,85,0,440,218,658
2012,7,Noruega,97,212,88,0,397,334,731
2012,7,Dinamarca,63,416,115,0,594,380,974
2012,7,Finlandia,2,12,2,0,16,4,20
2012,7,Suiza,521,960,325,0,1806,535,2341
2012,7,Austria,212,775,150,0,1137,113,1250
2012,7,Rusia,1597,2754,596,166,5113,2657,7770
2012,7,Países del Este,704,2812,456,5,3977,2239,6216
2012,7,Resto de Europa,641,1805,648,2,3096,1141,4237
2012,7,Estados Unidos,132,53,21,2,208,90,298
2012,7,Resto de América,59,98,96,0,253,72,325
2012,7,Resto del Mundo,296,132,79,0,507,170,677
2012,7,TOTAL,20111,66171,17924,991,105197,49264,154461
2012,8,España,5875,19516,7416,561,33368,12463,45831
2012,8,Holanda,358,2732,1330,15,4435,2184,6619
2012,8,Bélgica,1081,3457,388,17,4943,414,5357
2012,8,Alemania,2028,9043,3060,42,14173,3094,17267
2012,8,Francia,873,2398,1004,55,4330,1201,5531
2012,8,Gran Bretaña,4269,20839,4018,749,29875,18171,48046
2012,8,Irlanda,119,465,97,8,689,866,1555
2012,8,Italia,280,2761,782,89,3912,1881,5793
2012,8,Suecia,0,543,126,22,691,418,1109
2012,8,Noruega,18,347,12,53,430,179,609
2012,8,Dinamarca,13,376,57,180,626,182,808
2012,8,Finlandia,0,8,0,0,8,129,137
2012,8,Suiza,313,721,246,2,1282,342,1624
2012,8,Austria,168,774,101,0,1043,204,1247
2012,8,Rusia,1916,3073,836,232,6057,3608,9665
2012,8,Países del Este,578,2542,385,34,3539,2253,5792
2012,8,Resto de Europa,775,3872,615,8,5270,921,6191
2012,8,Estados Unidos,137,60,1,10,208,99,307
2012,8,Resto de América,33,113,70,17,233,83,316
2012,8,Resto del Mundo,150,220,38,8,416,521,937
2012,8,TOTAL,18984,73860,20582,2102,115528,49213,164741
2012,9,España,3247,13447,3139,347,20180,8016,28196
2012,9,Holanda,513,1923,672,13,3121,1246,4367
2012,9,Bélgica,1018,3308,354,12,4692,489,5181
2012,9,Alemania,3489,9316,2132,34,14971,2576,17547
2012,9,Francia,423,1121,621,50,2215,523,2738
2012,9,Gran Bretaña,5540,21237,4199,599,31575,18409,49984
2012,9,Irlanda,177,420,114,12,723,840,1563
2012,9,Italia,260,1582,302,24,2168,934,3102
2012,9,Suecia,7,475,96,14,592,356,948
2012,9,Noruega,74,332,22,89,517,201,718
2012,9,Dinamarca,13,410,8,195,626,224,850
2012,9,Finlandia,3,76,4,0,83,75,158
2012,9,Suiza,677,993,172,3,1845,365,2210
2012,9,Austria,187,629,57,0,873,82,955
2012,9,Rusia,915,2482,467,169,4033,2765,6798
2012,9,Países del Este,466,3328,493,62,4349,2475,6824
2012,9,Resto de Europa,332,1886,438,28,2684,706,3390
2012,9,Estados Unidos,109,38,4,5,156,64,220
2012,9,Resto de América,29,100,30,3,162,50,212
2012,9,Resto del Mundo,66,362,18,7,453,121,574
2012,9,TOTAL,17545,63465,13342,1666,96018,40517,136535
2012,10,España,1867,9527,2274,140,13808,4462,18270
2012,10,Holanda,706,3123,656,17,4502,2289,6791
2012,10,Bélgica,1594,3640,314,6,5554,447,6001
2012,10,Alemania,4090,9779,4188,21,18078,2974,21052
2012,10,Francia,388,1750,339,19,2496,1602,4098
2012,10,Gran Bretaña,7765,25401,3199,786,37151,20302,57453
2012,10,Irlanda,274,782,103,2,1161,583,1744
2012,10,Italia,106,1908,478,19,2511,594,3105
2012,10,Suecia,384,2119,540,48,3091,1702,4793
2012,10,Noruega,177,1390,354,84,2005,1323,3328
2012,10,Dinamarca,76,1293,165,444,1978,1247,3225
2012,10,Finlandia,190,1728,559,2,2479,1105,3584
2012,10,Suiza,906,1302,216,11,2435,588,3023
2012,10,Austria,441,512,77,2,1032,255,1287
2012,10,Rusia,753,2111,493,159,3516,3622,7138
2012,10,Países del Este,223,3005,528,24,3780,1980,5760
2012,10,Resto de Europa,325,1523,614,0,2462,799,3261
2012,10,Estados Unidos,107,119,6,0,232,36,268
2012,10,Resto de América,39,66,30,1,136,83,219
2012,10,Resto del Mundo,76,394,35,1,506,87,593
2012,10,TOTAL,20487,71472,15168,1786,108913,46080,154993
2012,11,España,1054,4532,1791,37,7414,3098,10512
2012,11,Holanda,461,2094,746,25,3326,2218,5544
2012,11,Bélgica,1316,3290,335,11,4952,1110,6062
2012,11,Alemania,4434,10647,2950,18,18049,2724,20773
2012,11,Francia,343,1372,367,20,2102,1714,3816
2012,11,Gran Bretaña,5981,21391,2535,677,30584,20117,50701
2012,11,Irlanda,197,547,62,4,810,644,1454
2012,11,Italia,111,1079,125,10,1325,628,1953
2012,11,Suecia,509,4588,843,87,6027,2351,8378
2012,11,Noruega,239,2542,563,102,3446,2253,5699
2012,11,Dinamarca,143,1532,163,411,2249,1701,3950
2012,11,Finlandia,530,2360,630,12,3532,1513,5045
2012,11,Suiza,545,878,161,9,1593,442,2035
2012,11,Austria,286,723,109,1,1119,323,1442
2012,11,Rusia,795,2221,546,268,3830,3653,7483
2012,11,Países del Este,284,2962,307,14,3567,1403,4970
2012,11,Resto de Europa,247,1101,414,0,1762,723,2485
2012,11,Estados Unidos,70,53,10,7,140,54,194
2012,11,Resto de América,13,26,9,2,50,51,101
2012,11,Resto del Mundo,112,404,22,4,542,73,615
2012,11,TOTAL,17670,64342,12688,1719,96419,46793,143212
2012,12,España,2193,5851,1987,20,10051,3703,13754
2012,12,Holanda,634,2170,652,12,3468,2367,5835
2012,12,Bélgica,1389,3695,313,16,5413,1130,6543
2012,12,Alemania,3401,8957,2724,16,15098,2669,17767
2012,12,Francia,333,1593,252,8,2186,1503,3689
2012,12,Gran Bretaña,6568,18717,2526,604,28415,18660,47075
2012,12,Irlanda,217,535,70,0,822,611,1433
2012,12,Italia,219,1963,179,10,2371,1000,3371
2012,12,Suecia,603,4452,995,4,6054,2636,8690
2012,12,Noruega,160,2049,511,4,2724,1476,4200
2012,12,Dinamarca,138,1445,441,0,2024,1547,3571
2012,12,Finlandia,546,2027,665,4,3242,1442,4684
2012,12,Suiza,461,717,120,7,1305,297,1602
2012,12,Austria,248,643,82,0,973,361,1334
2012,12,Rusia,780,1869,408,175,3232,2534,5766
2012,12,Países del Este,433,3148,256,6,3843,854,4697
2012,12,Resto de Europa,299,1111,298,3,1711,731,2442
2012,12,Estados Unidos,75,138,11,2,226,66,292
2012,12,Resto de América,28,43,20,11,102,96,198
2012,12,Resto del Mundo,123,715,35,2,875,150,1025
2012,12,TOTAL,18848,61838,12545,904,94135,43833,137968
2012,13,España,29319,123373,56495,2053,211240,77416,288656
2012,13,Holanda,6836,31210,9123,190,47359,20894,68253
2012,13,Bélgica,14370,43670,3647,205,61892,8251,70143
2012,13,Alemania,40190,122682,34787,283,197942,32111,230053
2012,13,Francia,5728,25031,5636,357,36752,18938,55690
2012,13,Gran Bretaña,72379,252597,33412,8679,367067,226876,593943
2012,13,Irlanda,2740,6737,928,37,10442,10002,20444
2012,13,Italia,2947,22644,3125,227,28943,11006,39949
2012,13,Suecia,3054,29634,5067,384,38139,15365,53504
2012,13,Noruega,2079,14407,3195,645,20326,11429,31755
2012,13,Dinamarca,789,13756,3469,3481,21495,12730,34225
2012,13,Finlandia,2743,13731,3454,60,19988,10417,30405
2012,13,Suiza,6328,9160,2051,52,17591,3675,21266
2012,13,Austria,3425,7811,1125,24,12385,2376,14761
2012,13,Rusia,11568,26108,4751,2149,44576,36542,81118
2012,13,Países del Este,4700,36674,5147,358,46879,21225,68104
2012,13,Resto de Europa,4828,18791,5625,65,29309,10740,40049
2012,13,Estados Unidos,1377,1110,96,38,2621,951,3572
2012,13,Resto de América,475,1044,429,85,2033,945,2978
2012,13,Resto del Mundo,2066,4205,409,79,6759,3015,9774
2012,13,TOTAL,217941,804375,181971,19451,1223738,534904,1758642
2013,1,España,1422,3653,4198,40,9313,2743,12056
2013,1,Holanda,680,2509,692,12,3893,2368,6261
2013,1,Bélgica,1012,3695,369,30,5106,1030,6136
2013,1,Alemania,2823,8983,2463,18,14287,2812,17099
2013,1,Francia,732,1856,313,46,2947,2065,5012
2013,1,Gran Bretaña,6177,18540,2456,659,27832,15911,43743
2013,1,Irlanda,283,577,66,5,931,507,1438
2013,1,Italia,330,2849,226,5,3410,1053,4463
2013,1,Suecia,601,4898,726,40,6265,2602,8867
2013,1,Noruega,230,1672,453,113,2468,2051,4519
2013,1,Dinamarca,184,1455,598,501,2738,1619,4357
2013,1,Finlandia,517,1646,562,0,2725,1624,4349
2013,1,Suiza,406,535,167,12,1120,387,1507
2013,1,Austria,129,791,85,0,1005,288,1293
2013,1,Rusia,804,2142,286,180,3412,3043,6455
2013,1,Países del Este,243,2036,274,10,2563,1239,3802
2013,1,Resto de Europa,243,1016,288,13,1560,862,2422
2013,1,Estados Unidos,58,112,15,2,187,56,243
2013,1,Resto de América,29,81,17,5,132,64,196
2013,1,Resto del Mundo,122,395,37,5,559,143,702
2013,1,TOTAL,17025,59441,14291,1696,92453,42467,134920
2013,2,España,1229,3842,4015,41,9127,3235,12362
2013,2,Holanda,920,2910,672,23,4525,2728,7253
2013,2,Bélgica,1464,3162,281,2,4909,847,5756
2013,2,Alemania,3994,8644,2578,13,15229,2400,17629
2013,2,Francia,543,1809,353,18,2723,1815,4538
2013,2,Gran Bretaña,6768,18173,1934,768,27643,15132,42775
2013,2,Irlanda,333,534,71,7,945,740,1685
2013,2,Italia,141,1738,109,6,1994,870,2864
2013,2,Suecia,518,4670,888,74,6150,2779,8929
2013,2,Noruega,300,2017,463,138,2918,2201,5119
2013,2,Dinamarca,156,1867,658,437,3118,1769,4887
2013,2,Finlandia,644,2237,662,7,3550,1660,5210
2013,2,Suiza,502,625,306,0,1433,342,1775
2013,2,Austria,317,796,103,6,1222,340,1562
2013,2,Rusia,336,1111,151,159,1757,2153,3910
2013,2,Países del Este,272,1396,308,3,1979,1067,3046
2013,2,Resto de Europa,289,1187,299,7,1782,606,2388
2013,2,Estados Unidos,119,87,12,1,219,50,269
2013,2,Resto de América,50,67,27,1,145,66,211
2013,2,Resto del Mundo,66,286,22,2,376,88,464
2013,2,TOTAL,18961,57158,13912,1713,91744,40888,132632
2013,3,España,2464,9202,5241,105,17012,8505,25517
2013,3,Holanda,780,2642,670,13,4105,2679,6784
2013,3,Bélgica,1719,3431,362,7,5519,976,6495
2013,3,Alemania,4760,9404,3347,18,17529,4019,21548
2013,3,Francia,578,2815,387,54,3834,2161,5995
2013,3,Gran Bretaña,7743,21060,2796,895,32494,19067,51561
2013,3,Irlanda,363,753,83,5,1204,781,1985
2013,3,Italia,144,1806,95,1,2046,614,2660
2013,3,Suecia,363,5728,1058,101,7250,3154,10404
2013,3,Noruega,256,2500,533,156,3445,2022,5467
2013,3,Dinamarca,139,1963,685,501,3288,1757,5045
2013,3,Finlandia,502,2214,857,7,3580,1503,5083
2013,3,Suiza,482,754,159,2,1397,278,1675
2013,3,Austria,396,634,93,2,1125,343,1468
2013,3,Rusia,891,2309,369,197,3766,3207,6973
2013,3,Países del Este,540,2729,315,14,3598,1628,5226
2013,3,Resto de Europa,408,1817,542,5,2772,758,3530
2013,3,Estados Unidos,127,128,10,3,268,123,391
2013,3,Resto de América,54,49,18,1,122,74,196
2013,3,Resto del Mundo,91,342,24,5,462,68,530
2013,3,TOTAL,22800,72280,17644,2092,114816,53717,168533
2013,4,España,1302,6141,4576,188,12207,5425,17632
2013,4,Holanda,833,3159,700,61,4753,2176,6929
2013,4,Bélgica,1838,3922,201,13,5974,490,6464
2013,4,Alemania,3414,7580,2807,226,14027,2058,16085
2013,4,Francia,668,3332,433,188,4621,1493,6114
2013,4,Gran Bretaña,8907,22543,2464,32,33946,17198,51144
2013,4,Irlanda,249,661,58,8,976,740,1716
2013,4,Italia,240,1546,126,69,1981,594,2575
2013,4,Suecia,265,2334,286,59,2944,1347,4291
2013,4,Noruega,113,790,180,78,1161,735,1896
2013,4,Dinamarca,54,1079,123,237,1493,539,2032
2013,4,Finlandia,217,1096,247,0,1560,532,2092
2013,4,Suiza,620,905,153,27,1705,383,2088
2013,4,Austria,224,420,55,29,728,214,942
2013,4,Rusia,1375,3108,600,96,5179,3212,8391
2013,4,Países del Este,814,2463,298,99,3674,1641,5315
2013,4,Resto de Europa,311,1343,477,9,2140,661,2801
2013,4,Estados Unidos,102,95,4,31,232,75,307
2013,4,Resto de América,57,47,42,0,146,74,220
2013,4,Resto del Mundo,70,156,25,39,290,104,394
2013,4,TOTAL,21673,62720,13855,1489,99737,39691,139428
2013,5,España,2607,10217,4916,195,17935,5986,23921
2013,5,Holanda,540,2325,466,6,3337,1628,4965
2013,5,Bélgica,1011,3197,131,27,4366,469,4835
2013,5,Alemania,3706,7551,3136,32,14425,2010,16435
2013,5,Francia,659,2666,357,49,3731,866,4597
2013,5,Gran Bretaña,7488,22287,1934,906,32615,20715,53330
2013,5,Irlanda,233,638,70,3,944,912,1856
2013,5,Italia,215,1120,155,27,1517,565,2082
2013,5,Suecia,21,121,7,87,236,120,356
2013,5,Noruega,60,51,65,26,202,99,301
2013,5,Dinamarca,9,484,43,181,717,109,826
2013,5,Finlandia,7,397,3,0,407,53,460
2013,5,Suiza,528,555,64,2,1149,115,1264
2013,5,Austria,214,342,59,4,619,90,709
2013,5,Rusia,1548,4625,649,372,7194,3049,10243
2013,5,Países del Este,469,2444,252,47,3212,2161,5373
2013,5,Resto de Europa,443,1714,335,0,2492,916,3408
2013,5,Estados Unidos,127,76,6,3,212,90,302
2013,5,Resto de América,97,114,37,7,255,111,366
2013,5,Resto del Mundo,194,187,25,11,417,141,558
2013,5,TOTAL,20176,61111,12710,1985,95982,40205,136187
2013,6,España,3024,12004,5551,326,20905,8857,29762
2013,6,Holanda,405,1719,516,8,2648,1041,3689
2013,6,Bélgica,980,3338,265,11,4594,411,5005
2013,6,Alemania,3021,7989,3099,24,14133,2129,16262
2013,6,Francia,434,1724,232,40,2430,863,3293
2013,6,Gran Bretaña,5997,22431,2700,706,31834,18897,50731
2013,6,Irlanda,210,724,115,8,1057,1549,2606
2013,6,Italia,209,1386,147,13,1755,622,2377
2013,6,Suecia,29,227,18,127,401,393,794
2013,6,Noruega,59,292,97,42,490,246,736
2013,6,Dinamarca,6,385,31,155,577,113,690
2013,6,Finlandia,7,90,4,1,102,95,197
2013,6,Suiza,497,613,139,7,1256,215,1471
2013,6,Austria,280,583,52,2,917,91,1008
2013,6,Rusia,1903,4452,649,226,7230,3859,11089
2013,6,Países del Este,744,3186,304,45,4279,1896,6175
2013,6,Resto de Europa,333,2202,478,4,3017,717,3734
2013,6,Estados Unidos,79,54,6,10,149,85,234
2013,6,Resto de América,71,64,63,7,205,77,282
2013,6,Resto del Mundo,149,160,28,22,359,108,467
2013,6,TOTAL,18437,63623,14494,1784,98338,42264,140602
2013,7,España,4034,14451,2485,342,21312,8348,29660
2013,7,Holanda,644,2216,814,18,3692,2485,6177
2013,7,Bélgica,1370,2345,148,36,3899,580,4479
2013,7,Alemania,2547,8587,3293,20,14447,3120,17567
2013,7,Francia,607,1392,277,33,2309,1516,3825
2013,7,Gran Bretaña,6672,20298,2648,541,30159,18798,48957
2013,7,Irlanda,98,649,90,11,848,1281,2129
2013,7,Italia,152,821,127,19,1119,753,1872
2013,7,Suecia,18,616,125,167,926,342,1268
2013,7,Noruega,97,867,241,32,1237,452,1689
2013,7,Dinamarca,51,761,212,245,1269,256,1525
2013,7,Finlandia,8,5,5,1,19,43,62
2013,7,Suiza,823,1124,281,12,2240,673,2913
2013,7,Austria,344,730,81,0,1155,262,1417
2013,7,Rusia,2075,4073,990,192,7330,3599,10929
2013,7,Países del Este,764,2783,326,34,3907,1891,5798
2013,7,Resto de Europa,500,3153,403,18,4074,630,4704
2013,7,Estados Unidos,190,73,12,20,295,100,395
2013,7,Resto de América,80,60,27,11,178,73,251
2013,7,Resto del Mundo,243,163,43,9,458,93,551
2013,7,TOTAL,21317,65167,12628,1761,100873,45295,146168
2013,8,España,5121,16290,5531,502,27444,11373,38817
2013,8,Holanda,360,2294,883,13,3550,2333,5883
2013,8,Bélgica,959,2990,212,19,4180,447,4627
2013,8,Alemania,3096,7582,4255,24,14957,3248,18205
2013,8,Francia,776,2815,459,58,4108,1754,5862
2013,8,Gran Bretaña,6677,24663,3142,791,35273,20758,56031
2013,8,Irlanda,120,668,85,5,878,1220,2098
2013,8,Italia,365,2536,474,64,3439,1508,4947
2013,8,Suecia,14,562,70,6,652,286,938
2013,8,Noruega,6,355,141,26,528,266,794
2013,8,Dinamarca,14,369,32,208,623,168,791
2013,8,Finlandia,6,8,2,0,16,57,73
2013,8,Suiza,386,545,187,6,1124,458,1582
2013,8,Austria,402,692,88,2,1184,171,1355
2013,8,Rusia,2142,4200,1146,196,7684,3997,11681
2013,8,Países del Este,668,2741,543,44,3996,1933,5929
2013,8,Resto de Europa,470,2992,578,23,4063,755,4818
2013,8,Estados Unidos,145,44,7,9,205,66,271
2013,8,Resto de América,59,69,37,11,176,89,265
2013,8,Resto del Mundo,221,250,51,12,534,54,588
2013,8,TOTAL,22007,72665,17923,2019,114614,50941,165555
2013,9,España,2746,11142,2628,241,16757,6979,23736
2013,9,Holanda,499,1978,558,16,3051,1315,4366
2013,9,Bélgica,1145,2963,261,17,4386,388,4774
2013,9,Alemania,3692,8598,3737,31,16058,2451,18509
2013,9,Francia,349,1358,584,47,2338,843,3181
2013,9,Gran Bretaña,6468,22837,2705,433,32443,16699,49142
2013,9,Irlanda,129,527,89,6,751,763,1514
2013,9,Italia,141,2376,260,24,2801,648,3449
2013,9,Suecia,7,481,50,6,544,305,849
2013,9,Noruega,86,295,134,44,559,291,850
2013,9,Dinamarca,6,404,18,266,694,144,838
2013,9,Finlandia,4,105,13,3,125,62,187
2013,9,Suiza,682,975,140,0,1797,519,2316
2013,9,Austria,277,699,59,5,1040,117,1157
2013,9,Rusia,1435,3616,1069,170,6290,3519,9809
2013,9,Países del Este,396,2308,575,67,3346,1785,5131
2013,9,Resto de Europa,247,2508,445,28,3228,639,3867
2013,9,Estados Unidos,133,105,11,10,259,47,306
2013,9,Resto de América,38,115,32,3,188,75,263
2013,9,Resto del Mundo,167,279,29,11,486,72,558
2013,9,TOTAL,18647,63669,13397,1428,97141,37661,134802
2013,10,España,1417,5955,3177,130,10679,4865,15544
2013,10,Holanda,1030,2764,730,12,4536,1758,6294
2013,10,Bélgica,1796,3006,210,20,5032,465,5497
2013,10,Alemania,5021,8914,4002,30,17967,3127,21094
2013,10,Francia,512,2229,432,53,3226,1605,4831
2013,10,Gran Bretaña,9147,26984,3188,724,40043,18366,58409
2013,10,Irlanda,239,705,100,13,1057,845,1902
2013,10,Italia,178,1320,261,27,1786,679,2465
2013,10,Suecia,286,3422,608,36,4352,1848,6200
2013,10,Noruega,240,1716,506,159,2621,1271,3892
2013,10,Dinamarca,53,1686,318,348,2405,966,3371
2013,10,Finlandia,126,1452,250,2,1830,702,2532
2013,10,Suiza,1200,1762,203,10,3175,658,3833
2013,10,Austria,376,625,77,0,1078,142,1220
2013,10,Rusia,1190,3389,1069,150,5798,4264,10062
2013,10,Países del Este,287,2541,482,24,3334,1881,5215
2013,10,Resto de Europa,432,2263,509,2,3206,724,3930
2013,10,Estados Unidos,48,51,11,5,115,58,173
2013,10,Resto de América,20,59,35,4,118,97,215
2013,10,Resto del Mundo,65,135,37,1,238,55,293
2013,10,TOTAL,23663,70978,16205,1750,112596,44376,156972
2013,11,España,1279,3945,4501,56,9781,3916,13697
2013,11,Holanda,482,2406,645,30,3563,1313,4876
2013,11,Bélgica,1319,3441,311,8,5079,770,5849
2013,11,Alemania,4563,11590,3807,61,20021,4088,24109
2013,11,Francia,388,1134,97,53,1672,1196,2868
2013,11,Gran Bretaña,6950,21480,2191,797,31418,17611,49029
2013,11,Irlanda,238,584,71,1,894,762,1656
2013,11,Italia,221,1224,154,41,1640,789,2429
2013,11,Suecia,808,5555,850,70,7283,2693,9976
2013,11,Noruega,418,2961,741,272,4392,2581,6973
2013,11,Dinamarca,79,1946,367,234,2626,1642,4268
2013,11,Finlandia,467,2487,517,16,3487,1585,5072
2013,11,Suiza,744,1271,174,17,2206,647,2853
2013,11,Austria,416,1051,118,4,1589,412,2001
2013,11,Rusia,1154,3136,756,196,5242,3671,8913
2013,11,Países del Este,360,3015,261,22,3658,1364,5022
2013,11,Resto de Europa,292,1600,547,1,2440,1026,3466
2013,11,Estados Unidos,84,67,4,3,158,48,206
2013,11,Resto de América,25,54,24,4,107,110,217
2013,11,Resto del Mundo,160,157,13,4,334,38,372
2013,11,TOTAL,20447,69104,16149,1890,107590,46262,153852
2013,12,España,1974,4774,3708,57,10513,3623,14136
2013,12,Holanda,593,2610,719,18,3940,1640,5580
2013,12,Bélgica,1410,4225,261,1,5897,1021,6918
2013,12,Alemania,3363,8229,3434,67,15093,3146,18239
2013,12,Francia,374,1545,232,27,2178,1395,3573
2013,12,Gran Bretaña,6876,21307,2487,722,31392,17030,48422
2013,12,Irlanda,245,580,56,8,889,780,1669
2013,12,Italia,256,2272,205,24,2757,804,3561
2013,12,Suecia,777,6292,852,61,7982,2484,10466
2013,12,Noruega,218,2452,535,164,3369,2342,5711
2013,12,Dinamarca,101,1942,688,404,3135,1684,4819
2013,12,Finlandia,435,2428,606,14,3483,1896,5379
2013,12,Suiza,450,830,189,13,1482,299,1781
2013,12,Austria,295,550,76,9,930,435,1365
2013,12,Rusia,950,2109,570,158,3787,2707,6494
2013,12,Países del Este,385,2616,269,24,3294,1006,4300
2013,12,Resto de Europa,328,1354,525,4,2211,742,2953
2013,12,Estados Unidos,107,60,11,5,183,56,239
2013,12,Resto de América,47,78,27,3,155,83,238
2013,12,Resto del Mundo,118,296,21,3,438,128,566
2013,12,TOTAL,19302,66549,15471,1786,103108,43301,146409
2013,13,España,21561,82219,68946,9591,141436,98867,214623
2013,13,Holanda,6717,26646,10670,1534,39279,26278,62717
2013,13,Bélgica,13673,36382,8282,557,50495,15396,58342
2013,13,Alemania,38432,92643,50142,6912,159637,57939,194201
2013,13,Francia,5579,22600,6763,1102,31451,19932,48950
2013,13,Gran Bretaña,73201,232543,68026,12075,326346,240480,541281
2013,13,Irlanda,2432,6535,2122,266,9488,9955,20349
2013,13,Italia,2231,19148,4272,562,23403,10998,32870
2013,13,Suecia,3660,34110,6238,683,43952,18945,62011
2013,13,Noruega,1927,14965,4910,1514,21737,15586,36220
2013,13,Dinamarca,795,13252,4676,3560,21237,12243,31603
2013,13,Finlandia,2925,14085,3814,58,20765,9795,30575
2013,13,Suiza,6000,10077,3479,509,16607,7582,21562
2013,13,Austria,3046,7224,2126,194,10522,4624,13425
2013,13,Rusia,11825,33723,15190,3513,50527,47382,90389
2013,13,Países del Este,4434,25797,9546,984,32733,23891,52146
2013,13,Resto de Europa,3463,18627,9900,973,25916,14780,34930
2013,13,Estados Unidos,1050,1094,218,90,2068,1113,2892
2013,13,Resto de América,476,884,420,129,1562,1226,2537
2013,13,Resto del Mundo,1274,2875,607,164,4165,1708,5226
2013,13,TOTAL,204701,695429,280347,44970,1033326,638720,1556849
2014,1,España,1137,2584,4341,46,8108,2717,10825
2014,1,Holanda,657,2536,739,25,3957,1207,5164
2014,1,Bélgica,1509,3650,444,23,5626,1096,6722
2014,1,Alemania,3463,9145,4204,54,16866,3176,20042
2014,1,Francia,561,2204,232,51,3048,1404,4452
2014,1,Gran Bretaña,6422,20507,2226,691,29846,15373,45219
2014,1,Irlanda,436,679,89,13,1217,935,2152
2014,1,Italia,403,1834,343,24,2604,1129,3733
2014,1,Suecia,372,5391,818,71,6652,2788,9440
2014,1,Noruega,204,2224,471,176,3075,2157,5232
2014,1,Dinamarca,81,1825,661,306,2873,2193,5066
2014,1,Finlandia,337,1713,471,2,2523,1961,4484
2014,1,Suiza,551,712,93,6,1362,287,1649
2014,1,Austria,297,806,124,0,1227,383,1610
2014,1,Rusia,1517,2416,652,196,4781,3511,8292
2014,1,Países del Este,561,1923,321,16,2821,1102,3923
2014,1,Resto de Europa,407,1210,467,2,2086,882,2968
2014,1,Estados Unidos,93,44,49,2,188,63,251
2014,1,Resto de América,39,39,23,0,101,30,131
2014,1,Resto del Mundo,142,166,10,5,323,40,363
2014,1,TOTAL,19189,61608,16778,1709,99284,42434,141718
2014,2,España,1004,2471,3886,69,7430,1969,9399
2014,2,Holanda,689,2874,683,38,4284,2022,6306
2014,2,Bélgica,1520,3385,393,13,5311,550,5861
2014,2,Alemania,3887,8331,3526,25,15769,2477,18246
2014,2,Francia,699,2496,216,45,3456,1450,4906
2014,2,Gran Bretaña,8082,21292,3817,604,33795,12529,46324
2014,2,Irlanda,373,704,94,2,1173,693,1866
2014,2,Italia,191,1566,247,32,2036,661,2697
2014,2,Suecia,285,5099,601,50,6035,2582,8617
2014,2,Noruega,291,2546,771,161,3769,2224,5993
2014,2,Dinamarca,162,2274,635,335,3406,1972,5378
2014,2,Finlandia,466,2301,479,19,3265,1685,4950
2014,2,Suiza,653,784,311,8,1756,250,2006
2014,2,Austria,483,899,103,1,1486,284,1770
2014,2,Rusia,438,1272,307,99,2116,1994,4110
2014,2,Países del Este,282,1860,243,12,2397,764,3161
2014,2,Resto de Europa,270,1399,496,8,2173,860,3033
2014,2,Estados Unidos,121,99,3,13,236,31,267
2014,2,Resto de América,40,54,13,0,107,44,151
2014,2,Resto del Mundo,121,138,21,4,284,59,343
2014,2,TOTAL,20057,61844,16845,1538,100284,35100,135384
2014,3,España,957,3309,3648,79,7993,3292,11285
2014,3,Holanda,664,3215,880,41,4800,1956,6756
2014,3,Bélgica,2076,4464,386,24,6950,704,7654
2014,3,Alemania,4047,9415,4246,65,17773,2997,20770
2014,3,Francia,623,3049,317,50,4039,1782,5821
2014,3,Gran Bretaña,8915,22128,4762,586,36391,15024,51415
2014,3,Irlanda,307,633,95,11,1046,946,1992
2014,3,Italia,86,2681,289,21,3077,764,3841
2014,3,Suecia,477,5514,872,100,6963,3437,10400
2014,3,Noruega,227,2801,820,267,4115,2403,6518
2014,3,Dinamarca,150,2254,972,283,3659,2183,5842
2014,3,Finlandia,469,2346,809,10,3634,1629,5263
2014,3,Suiza,538,926,250,3,1717,329,2046
2014,3,Austria,318,627,76,4,1025,244,1269
2014,3,Rusia,486,2017,516,141,3160,2237,5397
2014,3,Países del Este,231,2058,245,28,2562,1064,3626
2014,3,Resto de Europa,330,1700,630,4,2664,860,3524
2014,3,Estados Unidos,63,58,8,15,144,41,185
2014,3,Resto de América,31,54,37,3,125,55,180
2014,3,Resto del Mundo,76,199,28,17,320,204,524
2014,3,TOTAL,21071,69448,19886,1752,112157,42151,154308
2014,4,España,2202,9028,4863,232,16325,7067,23392
2014,4,Holanda,736,2897,649,30,4312,1543,5855
2014,4,Bélgica,1857,4285,302,7,6451,708,7159
2014,4,Alemania,3378,8327,3922,80,15707,2910,18617
2014,4,Francia,711,3174,415,70,4370,1336,5706
2014,4,Gran Bretaña,9632,24248,4058,767,38705,16324,55029
2014,4,Irlanda,300,850,128,6,1284,799,2083
2014,4,Italia,245,1693,265,29,2232,705,2937
2014,4,Suecia,248,2784,370,60,3462,1659,5121
2014,4,Noruega,160,1676,242,163,2241,949,3190
2014,4,Dinamarca,118,1667,439,141,2365,1017,3382
2014,4,Finlandia,159,1098,235,4,1496,460,1956
2014,4,Suiza,662,1076,288,6,2032,376,2408
2014,4,Austria,292,512,82,8,894,212,1106
2014,4,Rusia,963,1969,960,193,4085,2439,6524
2014,4,Países del Este,217,2172,280,42,2711,853,3564
2014,4,Resto de Europa,377,1920,665,32,2994,649,3643
2014,4,Estados Unidos,102,111,11,16,240,61,301
2014,4,Resto de América,35,141,33,3,212,66,278
2014,4,Resto del Mundo,140,157,12,14,323,549,872
2014,4,TOTAL,22534,69785,18219,1903,112441,40682,153123
2014,5,España,3188,11074,7884,249,22395,7267,29662
2014,5,Holanda,546,2165,366,15,3092,1162,4254
2014,5,Bélgica,1153,2459,109,16,3737,380,4117
2014,5,Alemania,3266,7700,3577,44,14587,2408,16995
2014,5,Francia,674,2538,284,55,3551,774,4325
2014,5,Gran Bretaña,8845,24944,4501,736,39026,18945,57971
2014,5,Irlanda,268,721,117,5,1111,1190,2301
2014,5,Italia,205,1780,277,47,2309,863,3172
2014,5,Suecia,18,112,9,17,156,320,476
2014,5,Noruega,25,34,4,8,71,168,239
2014,5,Dinamarca,14,478,10,246,748,192,940
2014,5,Finlandia,7,313,0,3,323,168,491
2014,5,Suiza,636,722,139,6,1503,187,1690
2014,5,Austria,204,494,27,2,727,105,832
2014,5,Rusia,1124,4005,1358,284,6771,2997,9768
2014,5,Países del Este,401,2462,202,79,3144,1275,4419
2014,5,Resto de Europa,204,2096,513,23,2836,677,3513
2014,5,Estados Unidos,60,87,6,8,161,66,227
2014,5,Resto de América,22,118,81,17,238,133,371
2014,5,Resto del Mundo,197,219,42,18,476,590,1066
2014,5,TOTAL,21057,64521,19506,1878,106962,39867,146829
2014,6,España,3.372,13.352,6.024,282,23.030,8.494,31.524
2014,6,Holanda,0,1.640,395,10,2.358,648,3.006
2014,6,Bélgica,918,2.709,219,13,3.859,343,4.202
2014,6,Alemania,2.891,8.349,3.833,40,15.113,3.025,18.138
2014,6,Francia,330,1.532,337,58,2.257,845,3.102
2014,6,Gran Bretaña,6.889,22.867,4.458,551,34.765,16.431,51.196
2014,6,Irlanda,255,861,215,4,1.335,1.314,2.649
2014,6,Italia,148,1.692,529,20,2.389,677,3.066
2014,6,Suecia,25,402,9,3,439,368,807
2014,6,Noruega,29,316,11,7,363,131,494
2014,6,Dinamarca,25,494,32,275,826,234,1.060
2014,6,Finlandia,25,5,0,3,33,105,138
2014,6,Suiza,483,656,167,20,1.326,160,1.486
2014,6,Austria,189,501,81,0,771,65,836
2014,6,Rusia,1.222,4.887,1.777,251,8.137,3.293,11.430
2014,6,Países del Este,341,2.532,243,59,3.175,1.188,4.363
2014,6,Resto de Europa,403,2.719,666,20,3.808,787,4.595
2014,6,Estados Unidos,105,71,7,2,185,60,245
2014,6,Resto de América,45,110,106,13,274,135,409
2014,6,Resto del Mundo,133,162,60,7,362,85,447
2014,6,TOTAL,17828,65857,19169,1638,104805,38.388,143193
2014,7,España,3.624,14.751,4.645,421,23.441,9.021,32.462
2014,7,Holanda,406,2.123,1.014,22,3.565,1.876,5.441
2014,7,Bélgica,1.371,3.036,190,24,4.621,616,5.237
2014,7,Alemania,2.232,7.969,3.475,18,13.694,3.589,17.283
2014,7,Francia,553,1.804,292,72,2.721,1.520,4.241
2014,7,Gran Bretaña,8.142,24.781,5.530,526,38.979,17.381,56.360
2014,7,Irlanda,157,694,202,1,1.054,974,2.028
2014,7,Italia,146,937,911,34,2.028,1.149,3.177
2014,7,Suecia,16,553,29,9,607,293,900
2014,7,Noruega,50,884,12,19,965,218,1.183
2014,7,Dinamarca,38,803,43,369,1.253,398,1.651
2014,7,Finlandia,3,2,0,0,5,100,105
2014,7,Suiza,569,1.276,382,10,2.237,314,2.551
2014,7,Austria,254,805,65,2,1.126,158,1.284
2014,7,Rusia,1.361,4.519,1.605,219,7.704,3.222,10.926
2014,7,Países del Este,502,3.297,380,50,4.229,1.197,5.426
2014,7,Resto de Europa,577,3.161,509,23,4.270,577,4.847
2014,7,Estados Unidos,88,115,2,5,210,70,280
2014,7,Resto de América,58,107,64,12,241,86,327
2014,7,Resto del Mundo,231,280,38,23,572,107,679
2014,7,TOTAL,20378,71897,19388,1859,113522,42.866,156388
2014,8,España,4.723,15.114,6.424,562,26.823,10.203,37.026
2014,8,Holanda,330,2.713,1.022,22,4.087,1.569,5.656
2014,8,Bélgica,957,2.925,238,28,4.148,565,4.713
2014,8,Alemania,2.650,10.032,5.147,64,17.893,5.478,23.371
2014,8,Francia,710,2.916,449,135,4.210,1.931,6.141
2014,8,Gran Bretaña,8.156,25.890,5.496,766,40.308,20.489,60.797
2014,8,Irlanda,94,601,182,8,885,1.262,2.147
2014,8,Italia,243,2.397,930,80,3.650,1.788,5.438
2014,8,Suecia,12,458,9,6,485,325,810
2014,8,Noruega,17,298,5,6,326,115,441
2014,8,Dinamarca,7,540,18,263,828,182,1.010
2014,8,Finlandia,7,0,0,0,7,128,135
2014,8,Suiza,332,788,282,8,1.410,89,1.499
2014,8,Austria,202,825,85,8,1.120,158,1.278
2014,8,Rusia,1.411,3.993,1.744,217,7.365,3.258,10.623
2014,8,Países del Este,502,2.507,384,77,3.470,1.125,4.595
2014,8,Resto de Europa,536,3.022,542,18,4.118,759,4.877
2014,8,Estados Unidos,100,53,12,13,178,46,224
2014,8,Resto de América,39,102,47,14,202,86,288
2014,8,Resto del Mundo,161,245,53,9,468,106,574
2014,8,TOTAL,21189,75419,23069,2304,121981,49.662,171643
2014,9,España,3.564,8.734,3.482,267,16.047,7.734,23.781
2014,9,Holanda,356,2.145,720,8,3.229,1.203,4.432
2014,9,Bélgica,1.154,3.735,250,15,5.154,407,5.561
2014,9,Alemania,3.218,8.192,3.870,70,15.350,3.432,18.782
2014,9,Francia,417,1.588,256,63,2.324,1.083,3.407
2014,9,Gran Bretaña,7.830,24.161,4.975,746,37.712,17.543,55.255
2014,9,Irlanda,151,722,118,7,998,952,1.950
2014,9,Italia,138,1.912,390,56,2.496,1.207,3.703
2014,9,Suecia,25,727,23,50,825,520,1.345
2014,9,Noruega,29,442,35,3,509,129,638
2014,9,Dinamarca,10,479,29,272,790,195,985
2014,9,Finlandia,12,194,5,2,213,125,338
2014,9,Suiza,807,1.063,194,17,2.081,363,2.444
2014,9,Austria,234,511,56,4,805,112,917
2014,9,Rusia,979,2.985,1.523,161,5.648,3.449,9.097
2014,9,Países del Este,260,2.468,345,38,3.111,1.472,4.583
2014,9,Resto de Europa,382,2.678,563,37,3.660,579,4.239
2014,9,Estados Unidos,84,62,6,8,160,22,182
2014,9,Resto de América,49,64,50,7,170,115,285
2014,9,Resto del Mundo,204,206,39,21,470,114,584
2014,9,TOTAL,19903,63068,16929,1852,101752,40.756,142508
2014,10,España,1.583,6.537,3.667,200,11.987,4.515,16.502
2014,10,Holanda,646,3.209,924,16,4.795,1.164,5.959
2014,10,Bélgica,1.404,4.347,307,22,6.080,493,6.573
2014,10,Alemania,4.010,10.552,4.338,71,18.971,4.236,23.207
2014,10,Francia,648,2.671,545,59,3.923,1.867,5.790
2014,10,Gran Bretaña,10.508,27.630,6.739,819,45.696,20.414,66.110
2014,10,Irlanda,191,677,181,3,1.052,802,1.854
2014,10,Italia,187,2.126,476,61,2.850,962,3.812
2014,10,Suecia,267,2.818,338,44,3.467,1.393,4.860
2014,10,Noruega,123,1.138,288,76,1.625,1.256,2.881
2014,10,Dinamarca,89,1.318,230,234,1.871,805,2.676
2014,10,Finlandia,162,1.791,264,17,2.234,1.012,3.246
2014,10,Suiza,1.229,1.859,239,11,3.338,530,3.868
2014,10,Austria,181,705,85,2,973,201,1.174
2014,10,Rusia,995,2.645,1.119,207,4.966,4.007,8.973
2014,10,Países del Este,245,2.862,411,41,3.559,1.262,4.821
2014,10,Resto de Europa,353,2.196,778,41,3.368,859,4.227
2014,10,Estados Unidos,202,96,4,9,311,64,375
2014,10,Resto de América,56,76,117,10,259,64,323
2014,10,Resto del Mundo,184,244,71,4,503,137,640
2014,10,TOTAL,23263,75497,21121,1947,121828,46.043,167871
2014,11,España,1.139,3.840,4.062,51,9.092,2.660,11.752
2014,11,Holanda,410,2.569,1.034,10,4.023,1.305,5.328
2014,11,Bélgica,1.555,4.014,518,15,6.102,611,6.713
2014,11,Alemania,4.369,11.443,4.108,20,19.940,3.374,23.314
2014,11,Francia,421,1.607,302,54,2.384,1.378,3.762
2014,11,Gran Bretaña,7.104,19.334,3.660,649,30.747,14.748,45.495
2014,11,Irlanda,198,435,92,5,730,507,1.237
2014,11,Italia,236,2.159,390,33,2.818,1.216,4.034
2014,11,Suecia,685,5.072,765,196,6.718,2.583,9.301
2014,11,Noruega,455,1.943,588,143,3.129,1.756,4.885
2014,11,Dinamarca,316,1.894,314,331,2.855,1.360,4.215
2014,11,Finlandia,309,1.976,568,12,2.865,1.224,4.089
2014,11,Suiza,819,1.365,227,6,2.417,452,2.869
2014,11,Austria,327,1.038,134,4,1.503,383,1.886
2014,11,Rusia,600,1.297,617,67,2.581,2.095,4.676
2014,11,Países del Este,187,2.696,374,8,3.265,1.072,4.337
2014,11,Resto de Europa,327,1.467,709,15,2.518,760,3.278
2014,11,Estados Unidos,104,72,0,3,179,31,210
2014,11,Resto de América,16,56,117,3,192,45,237
2014,11,Resto del Mundo,175,130,35,11,351,78,429
2014,11,TOTAL,19752,64407,18614,1636,104409,37.638,142047
2014,12,España,1.923,5.009,4.279,73,11.284,3.427,14.711
2014,12,Holanda,554,2.398,901,7,3.860,1.710,5.570
2014,12,Bélgica,1.512,4.294,346,9,6.161,856,7.017
2014,12,Alemania,2.910,9.436,3.489,87,15.922,2.834,18.756
2014,12,Francia,601,1.972,457,30,3.060,1.547,4.607
2014,12,Gran Bretaña,7.726,20.032,4.189,679,32.626,13.923,46.549
2014,12,Irlanda,250,416,102,9,777,689,1.466
2014,12,Italia,341,2.454,468,36,3.299,1.193,4.492
2014,12,Suecia,523,4.670,756,138,6.087,2.390,8.477
2014,12,Noruega,177,1.668,331,147,2.323,1.287,3.610
2014,12,Dinamarca,149,1.591,560,268,2.568,1.250,3.818
2014,12,Finlandia,256,1.711,437,15,2.419,1.673,4.092
2014,12,Suiza,467,812,183,19,1.481,324,1.805
2014,12,Austria,238,846,89,0,1.173,554,1.727
2014,12,Rusia,627,1.013,443,74,2.157,1.475,3.632
2014,12,Países del Este,249,2.547,271,12,3.079,952,4.031
2014,12,Resto de Europa,316,1.847,594,26,2.783,871,3.654
2014,12,Estados Unidos,122,66,11,1,200,79,279
2014,12,Resto de América,23,67,65,6,161,57,218
2014,12,Resto del Mundo,145,277,39,21,482,159,641
2014,12,TOTAL,19109,63126,18010,1657,101902,37.250,139152
2014,13,España,28.416,95.803,57.205,2.531,183.955,68.366,252.321
2014,13,Holanda,5.994,30.484,9.327,244,46.362,17.365,63.727
2014,13,Bélgica,16.986,43.303,3.702,209,64.200,7.329,71.529
2014,13,Alemania,40.321,108.891,47.735,638,197.585,39.936,237.521
2014,13,Francia,6.948,27.551,4.102,742,39.343,16.917,56.260
2014,13,Gran Bretaña,98.251,277.814,54.411,8.120,438.596,199.124,637.720
2014,13,Irlanda,2.980,7.993,1.615,74,12.662,11.063,23.725
2014,13,Italia,2.569,23.231,5.515,473,31.788,12.314,44.102
2014,13,Suecia,2.953,33.600,4.599,744,41.896,18.658,60.554
2014,13,Noruega,1.787,15.970,3.578,1.176,22.511,12.793,35.304
2014,13,Dinamarca,1.159,15.617,3.943,3.323,24.042,11.981,36.023
2014,13,Finlandia,2.212,13.450,3.268,87,19.017,10.270,29.287
2014,13,Suiza,7.746,12.039,2.755,120,22.660,3.661,26.321
2014,13,Austria,3.219,8.569,1.007,35,12.830,2.859,15.689
2014,13,Rusia,11.723,33.018,12.621,2.109,59.471,33.977,93.448
2014,13,Países del Este,3.978,29.384,3.699,462,37.523,13.326,50.849
2014,13,Resto de Europa,4.482,25.415,7.132,249,37.278,9.120,46.398
2014,13,Estados Unidos,1.244,934,119,95,2.392,634,3.026
2014,13,Resto de América,453,988,753,88,2.282,916,3.198
2014,13,Resto del Mundo,1.909,2.423,448,154,4.934,2.228,7.162
2014,13,TOTAL,245.330,806.477,227.534,21.673,1.301.327,492.837,1.794.164
2015,1,España,1337,3.018,3419,96,7.870,2.204,10.074
2015,1,Holanda,527,2.583,742,18,3.870,1650,5.520
2015,1,Bélgica,1.388,4.121,429,47,5.985,887,6.872
2015,1,Alemania,3456,9.501,3734,65,16.756,2.728,19.484
2015,1,Francia,640,2.435,542,65,3.682,1.592,5.274
2015,1,Reino Unido,7402,18560,3608,1437,31.007,13613,44.620
2015,1,Irlanda,341,521,113,15,990,717,1.707
2015,1,Italia,353,3.014,537,63,3.967,1.644,5.611
2015,1,Suecia,659,4.432,803,311,6.205,2.149,8.354
2015,1,Noruega,243,1.251,345,587,2.426,1.304,3.730
2015,1,Dinamarca,196,2.094,939,285,3.514,2.198,5.712
2015,1,Finlandia,316,1498,414,207,2.435,1170,3.605
2015,1,Suiza,396,662,231,8,1.297,175,1.472
2015,1,Austria,315,1013,175,2,1505,370,1.875
2015,1,Rusia,877,1.108,469,229,2.683,2201,4.884
2015,1,Países del Este,364,2.004,451,14,2.833,944,3.777
2015,1,Resto de Europa,327,1707,552,53,2639,1260,3899
2015,1,USA,53,32,4,8,97,83,180
2015,1,Resto de América,50,47,76,8,181,47,228
2015,1,Resto del Mundo,75,129,70,16,290,175,465
2015,1,TOTAL,19.315,59.730,17.653,3534,100.232,37.111,137.343
2015,2,España,1137,2.954,2974,82,7.147,2.138,9.285
2015,2,Holanda,630,2.757,512,42,3.941,1809,5.750
2015,2,Bélgica,1.773,3.891,209,57,5.930,650,6.580
2015,2,Alemania,3384,9.064,3317,88,15.853,2.575,18.428
2015,2,Francia,742,3.016,692,90,4.540,2.254,6.794
2015,2,Reino Unido,8469,21127,3535,1455,34.586,13806,48.392
2015,2,Irlanda,352,601,87,27,1.067,592,1.659
2015,2,Italia,183,1.682,438,33,2.336,1.050,3.386
2015,2,Suecia,524,4.202,357,375,5.458,2.161,7.619
2015,2,Noruega,250,1.591,321,340,2.502,1.493,3.995
2015,2,Dinamarca,260,2.511,746,145,3.662,2.403,6.065
2015,2,Finlandia,316,1980,363,264,2.923,1397,4.320
2015,2,Suiza,488,852,314,12,1.666,338,2.004
2015,2,Austria,343,783,64,5,1.195,303,1.498
2015,2,Rusia,164,315,184,155,818,789,1.607
2015,2,Países del Este,194,2.167,317,12,2.690,826,3.516
2015,2,Resto de Europa,269,1409,338,38,2054,1266,3320
2015,2,USA,111,43,18,16,188,88,276
2015,2,Resto de América,57,51,15,3,126,44,170
2015,2,Resto del Mundo,52,107,64,34,257,123,380
2015,2,TOTAL,19.698,61.103,14.865,3273,98.939,36.105,135.044
2015,3,España,1750,4.295,1311,137,7.493,3.756,11.249
2015,3,Holanda,449,2.039,630,42,3.160,1702,4.862
2015,3,Bélgica,1.421,3.803,294,47,5.565,638,6.203
2015,3,Alemania,3683,9.244,4223,104,17.254,3.481,20.735
2015,3,Francia,594,1.583,893,129,3.199,1.585,4.784
2015,3,Reino Unido,10288,24435,4571,1356,40.650,16398,57.048
2015,3,Irlanda,434,630,132,20,1.216,744,1.960
2015,3,Italia,290,2.796,524,46,3.656,1.259,4.915
2015,3,Suecia,433,5036,643,468,6580,2499,9.079
2015,3,Noruega,268,1.803,413,531,3.015,1321,4.336
2015,3,Dinamarca,191,2519,854,423,3987,2037,6.024
2015,3,Finlandia,254,2.207,531,221,3.213,1362,4.575
2015,3,Suiza,519,709,168,10,1406,282,1.688
2015,3,Austria,296,643,101,3,1.043,296,1.339
2015,3,Rusia,339,513,232,158,1.242,1.101,2.343
2015,3,Países del Este,214,2.108,490,4,2.816,735,3.551
2015,3,Resto de Europa,324,1663,892,33,2912,1145,4057
2015,3,USA,87,80,18,9,194,112,306
2015,3,Resto de América,40,67,32,2,141,128,269
2015,3,Resto del Mundo,263,129,44,15,451,154,605
2015,3,TOTAL,22.137,66.302,16.996,3758,109.193,40.735,149.928
2015,4,España,2108,7.360,3694,458,13.620,6.309,19.929
2015,4,Holanda,683,3.416,608,17,4.724,1902,6.626
2015,4,Bélgica,2.080,5.493,293,34,7.900,704,8.604
2015,4,Alemania,3100,7.132,5956,79,16.267,3.465,19.732
2015,4,Francia,808,3.368,932,81,5.189,1.309,6.498
2015,4,Reino Unido,10251,21709,4062,1234,37.256,15978,53.234
2015,4,Irlanda,374,603,165,22,1.164,682,1.846
2015,4,Italia,364,2200,821,69,3454,1223,4677
2015,4,Suecia,345,2581,177,191,3294,1013,4307
2015,4,Noruega,70,579,73,63,785,372,1157
2015,4,Dinamarca,78,956,486,69,1589,851,2440
2015,4,Finlandia,60,711,102,77,950,422,1.372
2015,4,Suiza,801,1116,201,9,2127,345,2472
2015,4,Austria,298,439,82,2,821,183,1.004
2015,4,Rusia,517,875,557,148,2.097,1.232,3.329
2015,4,Países del Este,248,2.269,415,59,2.991,1.085,4.076
2015,4,Resto de Europa,542,2096,955,71,3664,1030,4694
2015,4,USA,125,88,23,7,243,135,378
2015,4,Resto de América,53,71,109,10,243,133,376
2015,4,Resto del Mundo,165,213,24,44,446,186,632
2015,4,TOTAL,23070,63275,19735,2744,108824,38559,147383
2015,5,España,3168,10594,3881,437,18080,6284,24364
2015,5,Holanda,798,3052,490,41,4381,1779,6160
2015,5,Bélgica,1252,2876,274,34,4436,663,5099
2015,5,Alemania,3097,7553,5241,48,15939,3737,19676
2015,5,Francia,719,3122,856,27,4724,1143,5867
2015,5,Reino Unido,9233,26901,4994,1520,42648,20311,62959
2015,5,Irlanda,347,770,212,27,1356,878,2234
2015,5,Italia,286,1976,561,64,2887,1370,4257
2015,5,Suecia,19,119,52,29,219,274,493
2015,5,Noruega,13,18,3,6,40,135,175
2015,5,Dinamarca,17,410,59,54,540,178,718
2015,5,Finlandia,11,237,12,14,274,254,528
2015,5,Suiza,606,820,94,3,1523,175,1698
2015,5,Austria,237,405,61,7,710,96,806
2015,5,Rusia,841,1118,481,257,2697,1923,4620
2015,5,Países del Este,389,2271,346,32,3038,1170,4208
2015,5,Resto de Europa,276,2392,662,35,3365,1074,4439
2015,5,USA,151,57,7,8,223,301,524
2015,5,Resto de América,29,120,191,3,343,151,494
2015,5,Resto del Mundo,170,279,49,12,510,818,1328
2015,5,TOTAL,21659,65090,18526,2658,107933,42714,150647
2015,6,España,3447,12160,3091,1302,20000,7887,27887
2015,6,Holanda,298,2111,298,29,2736,1507,4243
2015,6,Bélgica,874,3136,330,44,4384,835,5219
2015,6,Alemania,2330,7562,4481,55,14428,3751,18179
2015,6,Francia,402,1384,157,104,2047,839,2886
2015,6,Reino Unido,8194,25331,5924,1363,40812,19823,60635
2015,6,Irlanda,258,766,297,73,1394,1507,2901
2015,6,Italia,241,1984,403,140,2768,1439,4207
2015,6,Suecia,25,647,20,30,722,353,1075
2015,6,Noruega,29,272,39,69,409,194,603
2015,6,Dinamarca,37,650,67,94,848,77,925
2015,6,Finlandia,1,14,4,5,24,171,195
2015,6,Suiza,524,770,159,18,1471,229,1700
2015,6,Austria,175,570,20,0,765,63,828
2015,6,Rusia,754,1121,418,234,2527,1785,4312
2015,6,Países del Este,336,2786,428,94,3644,1201,4845
2015,6,Resto de Europa,373,3144,870,157,4544,1203,5747
2015,6,USA,115,52,10,9,186,272,458
2015,6,Resto de América,72,107,98,20,297,204,501
2015,6,Resto del Mundo,637,217,29,15,898,3897,4795
2015,6,TOTAL,19122,64784,17143,3855,104904,47237,152141
2015,7,España,12279,0,12279,2801,268,3069,34652
2015,7,Holanda,65,0,65,34,9,43,445
2015,7,Bélgica,86,0,86,20,11,31,261
2015,7,Alemania,405,0,405,113,149,262,10998
2015,7,Francia,302,0,302,221,21,242,2512
2015,7,Reino Unido,536,0,536,97,9,106,3943
2015,7,Irlanda,59,0,59,0,0,0,144
2015,7,Italia,425,0,425,127,7,134,586
2015,7,Suecia,19,0,19,8,0,8,95
2015,7,Noruega,59,0,59,2,0,2,68
2015,7,Dinamarca,40,0,40,8,0,8,242
2015,7,Finlandia,6,0,6,6,0,6,24
2015,7,Suiza,55,0,55,28,0,28,397
2015,7,Austria,26,0,26,27,0,27,438
2015,7,Rusia,140,0,140,17,0,17,386
2015,7,Países del Este,124,0,124,9,7,16,908
2015,7,Resto de Europa,171,0,171,59,0,59,1967
2015,7,USA,121,0,121,60,0,60,90
2015,7,Resto de América,289,0,289,19,7,26,188
2015,7,Resto del Mundo,368,0,368,60,4,64,314
2015,7,TOTAL,15575,0,15575,3716,492,4208,58658
2015,8,España,4938,16292,6396,1514,29140,9804,38944
2015,8,Holanda,485,3370,921,50,4826,1860,6686
2015,8,Bélgica,998,3855,349,46,5248,352,5600
2015,8,Alemania,2351,7550,4894,89,14884,5218,20102
2015,8,Francia,1015,2608,477,159,4259,1792,6051
2015,8,Reino Unido,8900,29578,5586,1847,45911,17661,63572
2015,8,Irlanda,234,449,222,48,953,1032,1985
2015,8,Italia,405,3276,1182,153,5016,2273,7289
2015,8,Suecia,13,495,9,34,551,27,578
2015,8,Noruega,6,204,11,65,286,120,406
2015,8,Dinamarca,10,425,30,337,802,114,916
2015,8,Finlandia,2,3,4,2,11,33,44
2015,8,Suiza,426,742,100,10,1278,128,1406
2015,8,Austria,263,652,109,6,1030,272,1302
2015,8,Rusia,887,906,426,175,2394,1771,4165
2015,8,Países del Este,465,2191,428,128,3212,820,4032
2015,8,Resto de Europa,588,3740,1041,146,5515,1385,6900
2015,8,USA,88,78,11,16,193,98,291
2015,8,Resto de América,44,151,93,13,301,129,430
2015,8,Resto del Mundo,330,244,23,81,678,539,1217
2015,8,TOTAL,22448,76809,22312,4919,126488,45428,171916
2015,9,España,3630,11365,3778,764,19537,5638,25175
2015,9,Holanda,446,2318,852,37,3653,1394,5047
2015,9,Bélgica,1043,2547,312,36,3938,430,4368
2015,9,Alemania,2918,6809,3982,169,13878,4170,18048
2015,9,Francia,373,1877,386,85,2721,956,3677
2015,9,Reino Unido,9157,26315,6233,1642,43347,16612,59959
2015,9,Irlanda,287,652,259,34,1232,826,2058
2015,9,Italia,188,1181,655,237,2261,1353,3614
2015,9,Suecia,14,639,4,88,745,81,826
2015,9,Noruega,54,542,0,156,752,123,875
2015,9,Dinamarca,26,508,21,167,722,262,984
2015,9,Finlandia,7,201,14,15,237,27,264
2015,9,Suiza,845,1020,88,12,1965,181,2146
2015,9,Austria,225,495,53,12,785,197,982
2015,9,Rusia,439,818,468,116,1841,1987,3828
2015,9,Países del Este,256,2150,467,121,2994,846,3840
2015,9,Resto de Europa,263,2570,949,114,3896,1189,5085
2015,9,USA,95,42,26,4,167,116,283
2015,9,Resto de América,30,105,187,8,330,107,437
2015,9,Resto del Mundo,387,241,42,28,698,221,919
2015,9,TOTAL,20683,62395,18776,3845,105699,36716,142415
2015,10,España,2137,7967,2574,392,13070,3933,17003
2015,10,Holanda,703,3808,908,30,5449,1788,7237
2015,10,Bélgica,1379,3182,309,46,4916,485,5401
2015,10,Alemania,3819,8427,5093,111,17450,4953,22403
2015,10,Francia,742,2544,683,84,4053,2026,6079
2015,10,Reino Unido,11929,34111,6346,1951,54337,19860,74197
2015,10,Irlanda,384,789,190,76,1439,697,2136
2015,10,Italia,270,2183,569,85,3107,1525,4632
2015,10,Suecia,216,2749,735,275,3975,734,4709
2015,10,Noruega,106,582,477,353,1518,680,2198
2015,10,Dinamarca,62,1640,336,542,2580,774,3354
2015,10,Finlandia,121,1211,302,186,1820,757,2577
2015,10,Suiza,1063,1664,113,10,2850,525,3375
2015,10,Austria,262,692,75,3,1032,245,1277
2015,10,Rusia,625,998,808,110,2541,2488,5029
2015,10,Países del Este,291,2441,617,83,3432,1153,4585
2015,10,Resto de Europa,319,2429,1261,89,4098,1744,5842
2015,10,USA,114,69,7,15,205,44,249
2015,10,Resto de América,112,144,172,7,435,132,567
2015,10,Resto del Mundo,187,286,27,22,522,169,691
2015,10,TOTAL,24841,77916,21602,4470,128829,44712,173541
2015,11,España,944,3533,1103,161,5741,2298,8039
2015,11,Holanda,411,2418,1044,23,3896,1231,5127
2015,11,Bélgica,1751,4540,644,59,6994,646,7640
2015,11,Alemania,4018,11144,4843,63,20068,4299,24367
2015,11,Francia,356,1209,387,66,2018,1143,3161
2015,11,Reino Unido,8680,23491,4923,1640,38734,15284,54018
2015,11,Irlanda,351,568,231,27,1177,640,1817
2015,11,Italia,226,2259,591,59,3135,1441,4576
2015,11,Suecia,554,4801,486,422,6263,1369,7632
2015,11,Noruega,398,963,316,627,2304,1416,3720
2015,11,Dinamarca,112,2032,172,477,2793,1013,3806
2015,11,Finlandia,214,1512,139,110,1975,1151,3126
2015,11,Suiza,750,980,217,18,1965,243,2208
2015,11,Austria,337,826,173,16,1352,257,1609
2015,11,Rusia,346,555,463,69,1433,1686,3119
2015,11,Países del Este,230,1849,787,53,2919,943,3862
2015,11,Resto de Europa,414,1515,1334,40,3303,1339,4642
2015,11,USA,94,55,19,13,181,155,336
2015,11,Resto de América,17,85,141,2,245,74,319
2015,11,Resto del Mundo,186,245,17,6,454,93,547
2015,11,TOTAL,20389,64580,18030,3951,106950,36721,143671
2015,12,España,2227,4774,1547,246,8794,2261,11055
2015,12,Holanda,504,2491,853,22,3870,1783,5653
2015,12,Bélgica,1598,4015,500,92,6205,912,7117
2015,12,Alemania,2697,8945,4245,82,15969,3455,19424
2015,12,Francia,553,1458,427,60,2498,1293,3791
2015,12,Reino Unido,9498,24668,4861,1480,40507,17195,57702
2015,12,Irlanda,325,614,156,34,1129,695,1824
2015,12,Italia,354,2412,731,121,3618,1434,5052
2015,12,Suecia,498,3985,1091,459,6033,1224,7257
2015,12,Noruega,77,1078,284,369,1808,825,2633
2015,12,Dinamarca,44,1582,911,305,2842,1061,3903
2015,12,Finlandia,173,1380,425,178,2156,1416,3572
2015,12,Suiza,502,697,125,29,1353,357,1710
2015,12,Austria,227,562,105,8,902,263,1165
2015,12,Rusia,402,658,402,60,1522,1267,2789
2015,12,Países del Este,288,1328,375,51,2042,838,2880
2015,12,Resto de Europa,363,2074,1031,53,3521,1412,4933
2015,12,USA,92,90,10,14,206,190,396
2015,12,Resto de América,57,100,148,6,311,96,407
2015,12,Resto del Mundo,179,508,58,11,756,205,961
2015,12,TOTAL,20658,63419,18285,3680,106042,38182,144224
2015,13,España,39102,84312,46047,8390,150760,55581,237656
2015,13,Holanda,5999,30363,7923,385,44515,18448,63356
2015,13,Bélgica,15643,41459,4029,562,61512,7233,68964
2015,13,Alemania,35258,92931,50414,1066,178895,42094,231576
2015,13,Francia,7246,24604,6734,1171,38951,16174,57374
2015,13,Reino Unido,102537,276226,55179,17022,449804,186647,640279
2015,13,Irlanda,3746,6963,2123,403,13117,9010,22271
2015,13,Italia,3585,24963,7437,1197,36212,16145,52802
2015,13,Suecia,3319,29686,4396,2690,40045,11892,52024
2015,13,Noruega,1573,8883,2341,3168,15845,7985,23896
2015,13,Dinamarca,1073,15327,4661,2906,23879,10976,35089
2015,13,Finlandia,1481,10954,2316,1285,16018,8166,24202
2015,13,Suiza,6975,10032,1865,167,18901,3006,22276
2015,13,Austria,3004,7080,1044,91,11140,2572,14123
2015,13,Rusia,6331,8985,5048,1728,21795,18247,40411
2015,13,Países del Este,3399,23564,5245,660,32618,10577,44080
2015,13,Resto de Europa,4229,24739,10056,888,39511,14106,55525
2015,13,USA,1246,686,274,179,2083,1654,3767
2015,13,Resto de América,850,1048,1551,101,2960,1271,4386
2015,13,Resto del Mundo,2999,2598,815,344,5964,6644,12854
2015,13,TOTAL,249595,725403,219498,44403,1204525,448428,1706911
2016,1,España,1340,3317,934,165,5756,1990,7746
2016,1,Holanda,462,2467,655,48,3632,1535,5167
2016,1,Bélgica,1531,3823,449,64,5867,901,6768
2016,1,Alemania,3154,8829,3964,106,16053,3655,19708
2016,1,Francia,593,2132,637,92,3454,1482,4936
2016,1,Reino Unido,8798,22719,4413,1847,37777,16605,54382
2016,1,Irlanda,489,747,211,28,1475,649,2124
2016,1,Italia,721,3428,596,117,4862,1872,6734
2016,1,Suecia,674,4876,1187,422,7159,1332,8491
2016,1,Noruega,197,1133,370,459,2159,1085,3244
2016,1,Dinamarca,103,2465,1201,506,4275,1482,5757
2016,1,Finlandia,145,1151,342,121,1759,1133,2892
2016,1,Suiza,357,571,193,27,1148,268,1416
2016,1,Austria,224,736,131,5,1096,308,1404
2016,1,Rusia,731,741,294,81,1847,1686,3533
2016,1,Países del Este,401,1285,402,42,2130,663,2793
2016,1,Resto de Europa,214,2120,731,47,3112,1812,4924
2016,1,USA,61,43,5,5,114,77,191
2016,1,Resto de América,46,49,37,9,141,46,187
2016,1,Resto del Mundo,283,323,51,18,675,202,877
2016,1,TOTAL,20524,62955,16803,4209,104491,38783,143274
2016,2,España,940,2687,1172,91,4890,1842,6732
2016,2,Holanda,679,3187,724,17,4607,2386,6993
2016,2,Bélgica,1647,4144,335,67,6193,591,6784
2016,2,Alemania,3285,9116,3897,79,16377,3436,19813
2016,2,Francia,708,2540,870,95,4213,1880,6093
2016,2,Reino Unido,11078,25716,4313,1706,42813,16477,59290
2016,2,Irlanda,402,797,193,29,1421,687,2108
2016,2,Italia,282,2923,598,67,3870,1247,5117
2016,2,Suecia,464,3649,823,381,5317,1140,6457
2016,2,Noruega,135,1406,526,490,2557,1025,3582
2016,2,Dinamarca,124,2622,1154,532,4432,1659,6091
2016,2,Finlandia,182,1586,428,172,2368,1088,3456
2016,2,Suiza,573,744,252,6,1575,212,1787
2016,2,Austria,302,675,90,7,1074,209,1283
2016,2,Rusia,237,454,214,8,913,860,1773
2016,2,Países del Este,367,1242,460,32,2101,677,2778
2016,2,Resto de Europa,308,2149,1019,38,3514,1436,4950
2016,2,USA,126,97,25,5,253,66,319
2016,2,Resto de América,25,87,43,11,166,68,234
2016,2,Resto del Mundo,145,322,35,12,514,214,728
2016,2,TOTAL,22009,66143,17171,3845,109168,37200,146368
2016,3,España,1899,6115,2257,395,10666,4145,14811
2016,3,Holanda,442,2375,985,28,3830,1739,5569
2016,3,Bélgica,1722,5025,589,75,7411,1024,8435
2016,3,Alemania,3514,9648,4971,119,18252,4534,22786
2016,3,Francia,789,1784,531,42,3146,1137,4283
2016,3,Reino Unido,11419,28940,5114,2295,47768,18384,66152
2016,3,Irlanda,565,949,180,32,1726,839,2565
2016,3,Italia,357,2388,549,57,3351,978,4329
2016,3,Suecia,419,3824,1020,477,5740,1178,6918
2016,3,Noruega,74,1118,483,373,2048,968,3016
2016,3,Dinamarca,81,2548,1145,515,4289,1321,5610
2016,3,Finlandia,162,1516,485,182,2345,1026,3371
2016,3,Suiza,530,924,128,12,1594,121,1715
2016,3,Austria,301,568,86,12,967,192,1159
2016,3,Rusia,273,553,274,30,1130,1166,2296
2016,3,Países del Este,355,1806,521,38,2720,851,3571
2016,3,Resto de Europa,233,2201,1209,79,3722,1616,5338
2016,3,USA,126,136,7,4,273,81,354
2016,3,Resto de América,74,74,164,5,317,88,405
2016,3,Resto del Mundo,192,469,41,18,720,329,1049
2016,3,TOTAL,23527,72961,20739,4788,122015,41717,163732
2016,4,España,1509,5753,1979,439,9680,3277,12957
2016,4,Holanda,964,4737,1553,80,7334,2969,10303
2016,4,Bélgica,1364,4312,576,73,6325,911,7236
2016,4,Alemania,2472,9332,4433,80,16317,4052,20369
2016,4,Francia,1028,5013,800,157,6998,2153,9151
2016,4,Reino Unido,12967,27700,5629,2411,48707,19708,68415
2016,4,Irlanda,381,851,217,11,1460,746,2206
2016,4,Italia,332,2178,642,89,3241,1404,4645
2016,4,Suecia,250,1832,455,209,2746,559,3305
2016,4,Noruega,28,465,208,124,825,266,1091
2016,4,Dinamarca,29,1162,656,177,2024,588,2612
2016,4,Finlandia,46,648,182,195,1071,435,1506
2016,4,Suiza,823,1175,131,30,2159,244,2403
2016,4,Austria,242,556,63,12,873,123,996
2016,4,Rusia,550,1083,787,135,2555,2084,4639
2016,4,Países del Este,394,1523,581,112,2610,1347,3957
2016,4,Resto de Europa,134,2281,1435,133,3983,1754,5737
2016,4,USA,186,203,20,15,424,108,532
2016,4,Resto de América,22,142,260,11,435,95,530
2016,4,Resto del Mundo,173,539,44,23,779,244,1023
2016,4,TOTAL,23894,71485,20651,4516,120546,43067,163613
2016,5,España,2343,9064,2922,675,15004,5398,20402
2016,5,Holanda,482,2980,1149,34,4645,1845,6490
2016,5,Bélgica,1054,3376,552,35,5017,804,5821
2016,5,Alemania,2821,10664,4763,67,18315,4482,22797
2016,5,Francia,532,2485,369,83,3469,538,4007
2016,5,Reino Unido,10586,30939,5946,2501,49972,18606,68578
2016,5,Irlanda,343,906,271,42,1562,916,2478
2016,5,Italia,354,2624,604,107,3689,1428,5117
2016,5,Suecia,12,88,9,9,118,91,209
2016,5,Noruega,33,23,11,45,112,86,198
2016,5,Dinamarca,19,404,26,134,583,59,642
2016,5,Finlandia,10,203,28,20,261,29,290
2016,5,Suiza,452,918,112,14,1496,246,1742
2016,5,Austria,164,454,14,7,639,103,742
2016,5,Rusia,509,1066,909,91,2575,1920,4495
2016,5,Países del Este,336,1861,378,95,2670,903,3573
2016,5,Resto de Europa,260,2564,1043,145,4012,1736,5748
2016,5,USA,169,63,9,7,248,124,372
2016,5,Resto de América,53,171,274,9,507,132,639
2016,5,Resto del Mundo,387,593,46,20,1046,603,1649
2016,5,TOTAL,20919,71446,19435,4140,115940,40049,155989
2016,6,España,3285,11307,3139,943,18674,5598,24272
2016,6,Holanda,328,2595,886,22,3831,1431,5262
2016,6,Bélgica,875,3044,309,44,4272,818,5090
2016,6,Alemania,2158,10101,4323,54,16636,4862,21498
2016,6,Francia,322,1604,243,71,2240,523,2763
2016,6,Reino Unido,9673,28465,7324,2729,48191,19551,67742
2016,6,Irlanda,345,1092,323,92,1852,1487,3339
2016,6,Italia,239,2043,696,139,3117,1371,4488
2016,6,Suecia,15,329,61,18,423,75,498
2016,6,Noruega,35,354,64,98,551,121,672
2016,6,Dinamarca,14,472,73,146,705,152,857
2016,6,Finlandia,2,9,54,16,81,24,105
2016,6,Suiza,490,783,51,8,1332,121,1453
2016,6,Austria,191,509,35,8,743,130,873
2016,6,Rusia,472,964,722,152,2310,2055,4365
2016,6,Países del Este,537,2497,435,138,3607,983,4590
2016,6,Resto de Europa,475,3052,1243,105,4875,1434,6309
2016,6,USA,217,41,31,13,302,104,406
2016,6,Resto de América,76,124,253,6,459,143,602
2016,6,Resto del Mundo,387,589,35,22,1033,574,1607
2016,6,TOTAL,20136,69974,20300,4824,115234,41557,156791
2016,7,España,3481,11929,3977,973,20360,6709,27069
2016,7,Holanda,407,4045,1635,92,6179,2368,8547
2016,7,Bélgica,1461,4800,807,154,7222,1418,8640
2016,7,Alemania,1707,9925,4870,54,16556,5678,22234
2016,7,Francia,471,1811,362,71,2715,1116,3831
2016,7,Reino Unido,11710,30149,7779,2763,52401,21239,73640
2016,7,Irlanda,340,722,312,163,1537,1187,2724
2016,7,Italia,198,1789,647,100,2734,1598,4332
2016,7,Suecia,29,295,37,35,396,54,450
2016,7,Noruega,42,507,23,183,755,209,964
2016,7,Dinamarca,28,459,106,236,829,289,1118
2016,7,Finlandia,4,14,0,4,22,13,35
2016,7,Suiza,609,1511,90,42,2252,338,2590
2016,7,Austria,253,1031,89,9,1382,363,1745
2016,7,Rusia,614,926,600,136,2276,2232,4508
2016,7,Países del Este,660,2488,244,195,3587,751,4338
2016,7,Resto de Europa,179,3179,917,242,4517,1297,5814
2016,7,USA,165,67,6,22,260,282,542
2016,7,Resto de América,74,124,166,45,409,199,608
2016,7,Resto del Mundo,389,991,48,41,1469,531,2000
2016,7,TOTAL,22821,76762,22715,5560,127858,47871,175729
2016,8,España,3704,13854,4983,704,23245,6709,29954
2016,8,Holanda,471,4290,1445,73,6279,1717,7996
2016,8,Bélgica,927,3529,388,229,5073,564,5637
2016,8,Alemania,2153,10216,4956,44,17369,4973,22342
2016,8,Francia,629,2071,277,70,3047,1403,4450
2016,8,Reino Unido,10647,30098,7066,3086,50897,20995,71892
2016,8,Irlanda,246,581,291,106,1224,986,2210
2016,8,Italia,316,2926,1201,128,4571,2186,6757
2016,8,Suecia,7,598,3,25,633,20,653
2016,8,Noruega,13,244,26,107,390,39,429
2016,8,Dinamarca,12,438,5,69,524,12,536
2016,8,Finlandia,3,4,0,0,7,9,16
2016,8,Suiza,316,771,89,6,1182,117,1299
2016,8,Austria,237,648,109,5,999,254,1253
2016,8,Rusia,677,777,420,64,1938,1712,3650
2016,8,Países del Este,670,2426,345,105,3546,777,4323
2016,8,Resto de Europa,430,3065,985,147,4627,1385,6012
2016,8,USA,165,85,8,6,264,170,434
2016,8,Resto de América,73,92,109,15,289,171,460
2016,8,Resto del Mundo,430,908,70,61,1469,456,1925
2016,8,TOTAL,22126,77621,22776,5050,127573,44655,172228
2016,9,España,2969,10481,3115,480,17045,4343,21388
2016,9,Holanda,448,2794,1089,41,4372,1076,5448
2016,9,Bélgica,936,3035,270,69,4310,716,5026
2016,9,Alemania,2875,10016,4428,74,17393,3987,21380
2016,9,Francia,243,1403,138,32,1816,791,2607
2016,9,Reino Unido,10060,26917,7006,3444,47427,20527,67954
2016,9,Irlanda,246,708,277,56,1287,1053,2340
2016,9,Italia,169,1803,633,62,2667,1143,3810
2016,9,Suecia,15,444,12,36,507,34,541
2016,9,Noruega,28,199,2,129,358,64,422
2016,9,Dinamarca,13,342,8,23,386,70,456
2016,9,Finlandia,14,121,14,19,168,31,199
2016,9,Suiza,713,1088,72,22,1895,222,2117
2016,9,Austria,261,583,66,10,920,158,1078
2016,9,Rusia,547,896,772,74,2289,2225,4514
2016,9,Países del Este,286,2357,495,76,3214,823,4037
2016,9,Resto de Europa,224,2317,732,64,3337,1499,4836
2016,9,USA,126,46,20,9,201,88,289
2016,9,Resto de América,60,96,126,18,300,117,417
2016,9,Resto del Mundo,438,632,60,21,1151,282,1433
2016,9,TOTAL,20671,66278,19335,4759,111043,39249,150292
2016,10,España,1720,6627,2323,236,10906,2712,13618
2016,10,Holanda,653,3670,1272,34,5629,1636,7265
2016,10,Bélgica,1767,4254,375,97,6493,618,7111
2016,10,Alemania,3665,11568,6095,64,21392,5328,26720
2016,10,Francia,730,2143,315,67,3255,1493,4748
2016,10,Reino Unido,12303,31762,6577,2590,53232,21136,74368
2016,10,Irlanda,372,833,185,57,1447,847,2294
2016,10,Italia,196,2266,483,58,3003,1200,4203
2016,10,Suecia,294,2274,560,337,3465,877,4342
2016,10,Noruega,170,1042,638,473,2323,804,3127
2016,10,Dinamarca,60,1308,251,392,2011,544,2555
2016,10,Finlandia,130,904,238,143,1415,689,2104
2016,10,Suiza,1409,1998,177,25,3609,433,4042
2016,10,Austria,285,766,80,0,1131,228,1359
2016,10,Rusia,552,929,754,82,2317,2122,4439
2016,10,Países del Este,565,2020,468,60,3113,978,4091
2016,10,Resto de Europa,355,2233,986,125,3699,1595,5294
2016,10,USA,113,120,14,7,254,58,312
2016,10,Resto de América,29,136,272,23,460,42,502
2016,10,Resto del Mundo,777,530,103,11,1421,278,1699
2016,10,TOTAL,26145,77383,22166,4881,130575,43618,174193
2016,11,España,828,3704,1024,71,5627,1310,6937
2016,11,Holanda,478,2462,985,38,3963,1004,4967
2016,11,Bélgica,1572,3971,637,18,6198,563,6761
2016,11,Alemania,4010,10503,4348,57,18918,3793,22711
2016,11,Francia,337,835,179,45,1396,985,2381
2016,11,Reino Unido,8477,23491,5181,1711,38860,18374,57234
2016,11,Irlanda,393,563,266,25,1247,680,1927
2016,11,Italia,239,2098,477,48,2862,1028,3890
2016,11,Suecia,566,4720,1016,580,6882,1300,8182
2016,11,Noruega,173,1160,997,373,2703,1098,3801
2016,11,Dinamarca,62,1770,269,389,2490,1080,3570
2016,11,Finlandia,147,1447,412,114,2120,852,2972
2016,11,Suiza,726,1117,153,11,2007,309,2316
2016,11,Austria,366,790,134,3,1293,341,1634
2016,11,Rusia,365,708,818,38,1929,1706,3635
2016,11,Países del Este,390,1864,358,41,2653,675,3328
2016,11,Resto de Europa,314,1632,930,18,2894,1629,4523
2016,11,USA,95,121,20,1,237,53,290
2016,11,Resto de América,44,105,176,8,333,32,365
2016,11,Resto del Mundo,809,389,35,6,1239,199,1438
2016,11,TOTAL,20391,63450,18415,3595,105851,37011,142862
2016,12,España,2217,5853,1434,152,9656,2189,11845
2016,12,Holanda,451,2098,838,54,3441,1281,4722
2016,12,Bélgica,1258,3948,524,50,5780,792,6572
2016,12,Alemania,3478,8180,4304,55,16017,3658,19675
2016,12,Francia,914,1574,396,40,2924,1231,4155
2016,12,Reino Unido,9540,26479,6944,2482,45445,20572,66017
2016,12,Irlanda,398,713,218,58,1387,936,2323
2016,12,Italia,450,2675,624,88,3837,1240,5077
2016,12,Suecia,411,3777,982,406,5576,1193,6769
2016,12,Noruega,87,1025,851,417,2380,617,2997
2016,12,Dinamarca,63,1517,617,378,2575,1088,3663
2016,12,Finlandia,180,1598,365,133,2276,889,3165
2016,12,Suiza,397,776,144,10,1327,159,1486
2016,12,Austria,196,648,102,5,951,314,1265
2016,12,Rusia,409,725,819,57,2010,1449,3459
2016,12,Países del Este,263,1991,448,73,2775,838,3613
2016,12,Resto de Europa,379,1775,1234,86,3474,1430,4904
2016,12,USA,148,136,39,20,343,104,447
2016,12,Resto de América,83,96,175,10,364,108,472
2016,12,Resto del Mundo,561,816,64,29,1470,380,1850
2016,12,TOTAL,21883,66400,21122,4603,114008,40468,154476
2016,13,España,26235,90691,29259,5324,151509,46222,197731
2016,13,Holanda,6265,37700,13216,561,57742,20987,78729
2016,13,Bélgica,16114,47261,5811,975,70161,9720,79881
2016,13,Alemania,35292,118098,55352,853,209595,52438,262033
2016,13,Francia,7296,25395,5117,865,38673,14732,53405
2016,13,Reino Unido,127258,333375,73292,29565,563490,232174,795664
2016,13,Irlanda,4520,9462,2944,699,17625,11013,28638
2016,13,Italia,3853,29141,7750,1060,41804,16695,58499
2016,13,Suecia,3156,26706,6165,2935,38962,7853,46815
2016,13,Noruega,1015,8676,4199,3271,17161,6382,23543
2016,13,Dinamarca,608,15507,5511,3497,25123,8344,33467
2016,13,Finlandia,1025,9201,2548,1119,13893,6218,20111
2016,13,Suiza,7395,12376,1592,213,21576,2790,24366
2016,13,Austria,3022,7964,999,83,12068,2723,14791
2016,13,Rusia,5936,9822,7383,948,24089,21217,45306
2016,13,Países del Este,5224,23360,5135,1007,34726,10266,44992
2016,13,Resto de Europa,3505,28568,12464,1229,45766,18623,64389
2016,13,USA,1697,1158,204,114,3173,1315,4488
2016,13,Resto de América,659,1296,2055,170,4180,1241,5421
2016,13,Resto del Mundo,4971,7101,632,282,12986,4292,17278
2016,13,TOTAL,265046,842858,241628,54770,1404302,495245,1899547
2017,1,España,1467,3718,772,76,6033,1405,7438
2017,1,Holanda,645,2697,692,36,4070,1268,5338
2017,1,Bélgica,2107,3907,388,35,6437,712,7149
2017,1,Alemania,3555,8259,2744,59,14617,3051,17668
2017,1,Francia,685,1912,282,37,2916,1053,3969
2017,1,Reino Unido,9905,22763,3787,2017,38472,16283,54755
2017,1,Irlanda,545,782,154,13,1494,698,2192
2017,1,Italia,417,3606,449,70,4542,1391,5933
2017,1,Suecia,901,5028,974,534,7437,1261,8698
2017,1,Noruega,156,1035,269,387,1847,963,2810
2017,1,Dinamarca,202,2566,770,449,3987,1381,5368
2017,1,Finlandia,231,1459,306,110,2106,810,2916
2017,1,Suiza,536,630,107,7,1280,167,1447
2017,1,Austria,311,688,109,0,1108,259,1367
2017,1,Rusia,718,940,456,46,2160,1357,3517
2017,1,Países del Este,317,1700,300,83,2400,758,3158
2017,1,Resto de Europa,381,1589,508,50,2528,1228,3756
2017,1,USA,119,64,15,4,202,48,250
2017,1,Resto de América,96,89,52,9,246,45,291
2017,1,Resto del Mundo,375,494,22,14,905,184,1089
2017,1,TOTAL,23669,63926,13156,4036,104787,34322,139109
2017,2,España,989,3090,634,193,4906,1470,6376
2017,2,Holanda,793,3307,640,28,4768,1653,6421
2017,2,Bélgica,1911,4011,338,86,6346,555,6901
2017,2,Alemania,3601,7669,2621,198,14089,3402,17491
2017,2,Francia,729,2931,422,50,4132,1546,5678
2017,2,Reino Unido,12174,24317,3589,808,40888,16631,57519
2017,2,Irlanda,527,762,132,98,1519,540,2059
2017,2,Italia,320,2545,305,53,3223,1022,4245
2017,2,Suecia,656,3964,764,811,6195,1105,7300
2017,2,Noruega,154,1088,489,382,2113,905,3018
2017,2,Dinamarca,344,2538,861,2191,5934,1479,7413
2017,2,Finlandia,320,1645,240,12,2217,893,3110
2017,2,Suiza,585,850,121,15,1571,146,1717
2017,2,Austria,442,906,63,0,1411,287,1698
2017,2,Rusia,323,576,191,65,1155,840,1995
2017,2,Países del Este,326,2000,270,83,2679,777,3456
2017,2,Resto de Europa,441,1664,598,49,2752,1550,4302
2017,2,USA,181,111,11,23,326,56,382
2017,2,Resto de América,52,88,21,9,170,57,227
2017,2,Resto del Mundo,518,400,17,41,976,306,1282
2017,2,TOTAL,25386,64462,12327,5195,107370,35220,142590
2017,3,España,1156,3646,817,195,5814,1858,7672
2017,3,Holanda,601,2508,723,45,3877,1113,4990
2017,3,Bélgica,1850,3717,334,43,5944,826,6770
2017,3,Alemania,3958,9647,3444,188,17237,4006,21243
2017,3,Francia,672,2342,399,234,3647,1135,4782
2017,3,Reino Unido,13572,27070,4444,1003,46089,21371,67460
2017,3,Irlanda,383,848,135,67,1433,826,2259
2017,3,Italia,383,2256,376,29,3044,1018,4062
2017,3,Suecia,426,3576,776,844,5622,1177,6799
2017,3,Noruega,97,934,284,192,1507,774,2281
2017,3,Dinamarca,131,2125,824,2017,5097,928,6025
2017,3,Finlandia,189,1755,317,38,2299,827,3126
2017,3,Suiza,562,978,127,4,1671,113,1784
2017,3,Austria,290,656,76,2,1024,150,1174
2017,3,Rusia,488,776,273,34,1571,1171,2742
2017,3,Países del Este,259,2128,297,63,2747,881,3628
2017,3,Resto de Europa,332,1665,818,49,2864,1616,4480
2017,3,USA,125,179,22,6,332,142,474
2017,3,Resto de América,61,117,51,3,232,95,327
2017,3,Resto del Mundo,577,694,20,57,1348,279,1627
2017,3,TOTAL,26112,67617,14557,5113,113399,40306,153705
2017,4,España,2867,8853,1856,938,14514,4015,18529
2017,4,Holanda,955,3798,916,69,5738,2308,8046
2017,4,Bélgica,1797,4288,499,48,6632,733,7365
2017,4,Alemania,3272,9172,3682,58,16184,4256,20440
2017,4,Francia,772,3996,965,133,5866,1621,7487
2017,4,Reino Unido,12818,29775,5596,904,49093,21672,70765
2017,4,Irlanda,562,1013,245,42,1862,917,2779
2017,4,Italia,540,2520,432,62,3554,1056,4610
2017,4,Suecia,144,2365,476,613,3598,683,4281
2017,4,Noruega,154,568,146,89,957,338,1295
2017,4,Dinamarca,53,1466,440,976,2935,617,3552
2017,4,Finlandia,56,881,170,6,1113,377,1490
2017,4,Suiza,835,1279,137,18,2269,335,2604
2017,4,Austria,302,579,67,0,948,196,1144
2017,4,Rusia,697,871,449,148,2165,1442,3607
2017,4,Países del Este,403,2342,272,77,3094,921,4015
2017,4,Resto de Europa,443,2212,954,120,3729,1823,5552
2017,4,USA,154,142,25,8,329,90,419
2017,4,Resto de América,58,154,72,14,298,75,373
2017,4,Resto del Mundo,332,583,44,33,992,616,1608
2017,4,TOTAL,27214,76857,17443,4356,125870,44091,169961
2017,5,España,3189,8712,1451,445,13797,3209,17006
2017,5,Holanda,625,2803,684,27,4139,1507,5646
2017,5,Bélgica,1550,3165,320,20,5055,609,5664
2017,5,Alemania,2855,9056,2637,68,14616,3374,17990
2017,5,Francia,488,2076,228,157,2949,531,3480
2017,5,Reino Unido,12314,32056,5586,945,50901,25584,76485
2017,5,Irlanda,339,1053,309,133,1834,1091,2925
2017,5,Italia,249,2340,523,127,3239,1091,4330
2017,5,Suecia,41,95,70,0,206,93,299
2017,5,Noruega,13,21,21,14,69,115,184
2017,5,Dinamarca,49,443,105,0,597,164,761
2017,5,Finlandia,14,166,92,0,272,41,313
2017,5,Suiza,735,856,75,30,1696,234,1930
2017,5,Austria,195,577,18,12,802,161,963
2017,5,Rusia,557,967,680,104,2308,1429,3737
2017,5,Países del Este,334,2347,623,116,3420,883,4303
2017,5,Resto de Europa,226,1895,923,53,3097,1531,4628
2017,5,USA,193,102,9,2,306,136,442
2017,5,Resto de América,54,74,61,6,195,185,380
2017,5,Resto del Mundo,368,484,58,28,938,375,1313
2017,5,TOTAL,24388,69288,14473,2287,110436,42343,152779
2017,6,España,4172,12948,1611,746,19477,3199,22676
2017,6,Holanda,502,2148,546,142,3338,1057,4395
2017,6,Bélgica,1080,2946,314,79,4419,578,4997
2017,6,Alemania,2793,10639,3155,94,16681,5265,21946
2017,6,Francia,344,1262,173,68,1847,523,2370
2017,6,Reino Unido,10432,29131,6240,2729,48532,28034,76566
2017,6,Irlanda,509,1235,335,393,2472,1594,4066
2017,6,Italia,316,2003,421,90,2830,911,3741
2017,6,Suecia,35,453,44,13,545,94,639
2017,6,Noruega,34,156,5,74,269,128,397
2017,6,Dinamarca,19,597,85,5,706,102,808
2017,6,Finlandia,2,29,5,19,55,54,109
2017,6,Suiza,616,675,33,27,1351,123,1474
2017,6,Austria,323,484,28,23,858,94,952
2017,6,Rusia,752,1086,671,125,2634,1851,4485
2017,6,Países del Este,482,2511,642,294,3929,1088,5017
2017,6,Resto de Europa,276,2787,805,269,4137,1344,5481
2017,6,USA,179,139,14,39,371,146,517
2017,6,Resto de América,52,125,41,20,238,133,371
2017,6,Resto del Mundo,471,485,23,48,1027,385,1412
2017,6,TOTAL,23389,71839,15191,5297,115716,46703,162419
2017,7,España,4372,15378,2135,906,22791,3948,26739
2017,7,Holanda,607,3648,891,173,5319,2211,7530
2017,7,Bélgica,1569,4715,408,165,6857,813,7670
2017,7,Alemania,2018,9171,3373,98,14660,4970,19630
2017,7,Francia,479,1717,186,56,2438,1248,3686
2017,7,Reino Unido,10569,28825,5848,2198,47440,23369,70809
2017,7,Irlanda,452,957,316,320,2045,1347,3392
2017,7,Italia,148,2265,413,81,2907,1000,3907
2017,7,Suecia,56,319,84,27,486,69,555
2017,7,Noruega,71,440,112,50,673,202,875
2017,7,Dinamarca,71,497,139,29,736,332,1068
2017,7,Finlandia,6,19,0,6,31,8,39
2017,7,Suiza,816,1422,51,35,2324,254,2578
2017,7,Austria,254,990,54,15,1313,311,1624
2017,7,Rusia,884,1014,508,68,2474,1522,3996
2017,7,Países del Este,433,2579,651,185,3848,864,4712
2017,7,Resto de Europa,292,3886,575,338,5091,934,6025
2017,7,USA,180,123,5,23,331,93,424
2017,7,Resto de América,74,86,23,27,210,101,311
2017,7,Resto del Mundo,569,711,138,69,1487,599,2086
2017,7,TOTAL,23920,78762,15910,4869,123461,44195,167656
2017,8,España,4951,15308,2710,941,23910,3992,27902
2017,8,Holanda,681,3871,1147,226,5925,1983,7908
2017,8,Bélgica,1347,3566,234,66,5213,495,5708
2017,8,Alemania,2403,9243,3458,172,15276,4863,20139
2017,8,Francia,637,1977,116,123,2853,1135,3988
2017,8,Reino Unido,11121,29769,5649,2405,48944,26220,75164
2017,8,Irlanda,305,949,207,296,1757,1170,2927
2017,8,Italia,276,3084,563,144,4067,1571,5638
2017,8,Suecia,24,526,62,7,619,43,662
2017,8,Noruega,22,342,73,30,467,32,499
2017,8,Dinamarca,0,411,123,6,540,90,630
2017,8,Finlandia,1,11,0,11,23,5,28
2017,8,Suiza,437,737,33,10,1217,100,1317
2017,8,Austria,324,613,35,17,989,227,1216
2017,8,Rusia,955,962,399,97,2413,1384,3797
2017,8,Países del Este,592,2171,518,284,3565,681,4246
2017,8,Resto de Europa,442,3417,662,241,4762,770,5532
2017,8,USA,183,97,16,10,306,81,387
2017,8,Resto de América,62,74,88,22,246,24,270
2017,8,Resto del Mundo,471,635,57,68,1231,479,1710
2017,8,TOTAL,25234,77763,16150,5176,124323,45345,169668
2017,9,España,4334,11499,1661,867,18361,2463,20824
2017,9,Holanda,1017,2821,688,183,4709,1167,5876
2017,9,Bélgica,1327,2986,258,69,4640,597,5237
2017,9,Alemania,3438,9769,2868,131,16206,4024,20230
2017,9,Francia,354,1549,99,92,2094,977,3071
2017,9,Reino Unido,12371,27968,5687,2747,48773,25814,74587
2017,9,Irlanda,439,1032,251,239,1961,1141,3102
2017,9,Italia,238,2051,439,191,2919,1076,3995
2017,9,Suecia,41,384,101,12,538,78,616
2017,9,Noruega,32,254,51,14,351,101,452
2017,9,Dinamarca,66,404,44,61,575,149,724
2017,9,Finlandia,6,179,19,17,221,41,262
2017,9,Suiza,934,1200,46,32,2212,196,2408
2017,9,Austria,215,799,41,48,1103,153,1256
2017,9,Rusia,683,890,442,110,2125,1752,3877
2017,9,Países del Este,399,2032,519,198,3148,836,3984
2017,9,Resto de Europa,4677,2551,583,250,8061,847,8908
2017,9,USA,151,78,5,17,251,57,308
2017,9,Resto de América,169,109,95,13,386,44,430
2017,9,Resto del Mundo,498,427,48,57,1030,300,1330
2017,9,TOTAL,31389,68982,13945,5348,119664,41813,161477
2017,10,España,2333,7969,1113,416,11831,1721,13552
2017,10,Holanda,912,3652,957,245,5766,1554,7320
2017,10,Bélgica,2177,3428,284,67,5956,547,6503
2017,10,Alemania,4229,10949,3793,312,19283,5034,24317
2017,10,Francia,692,2352,205,132,3381,1439,4820
2017,10,Reino Unido,13410,29788,5061,2209,50468,23425,73893
2017,10,Irlanda,455,991,201,233,1880,1001,2881
2017,10,Italia,256,1770,325,127,2478,1023,3501
2017,10,Suecia,203,2711,426,244,3584,981,4565
2017,10,Noruega,158,807,314,212,1491,608,2099
2017,10,Dinamarca,105,1309,272,313,1999,519,2518
2017,10,Finlandia,152,1477,205,64,1898,778,2676
2017,10,Suiza,1306,1791,145,37,3279,429,3708
2017,10,Austria,311,701,38,19,1069,214,1283
2017,10,Rusia,772,873,634,156,2435,1629,4064
2017,10,Países del Este,477,2497,878,233,4085,795,4880
2017,10,Resto de Europa,435,2358,625,284,3702,1251,4953
2017,10,USA,187,80,8,9,284,81,365
2017,10,Resto de América,72,105,35,31,243,35,278
2017,10,Resto del Mundo,412,697,76,17,1202,395,1597
2017,10,TOTAL,29054,76305,15595,5360,126314,43459,169773
2017,11,España,1801,4614,830,222,7467,1414,8881
2017,11,Holanda,586,2648,677,96,4007,960,4967
2017,11,Bélgica,1696,3615,485,47,5843,432,6275
2017,11,Alemania,4650,10668,2944,329,18591,3831,22422
2017,11,Francia,367,1373,103,64,1907,1047,2954
2017,11,Reino Unido,9492,23245,3639,2141,38517,20914,59431
2017,11,Irlanda,391,757,130,156,1434,528,1962
2017,11,Italia,293,2219,385,129,3026,931,3957
2017,11,Suecia,573,4115,923,313,5924,1784,7708
2017,11,Noruega,186,822,390,168,1566,958,2524
2017,11,Dinamarca,226,1540,274,501,2541,1127,3668
2017,11,Finlandia,601,1832,283,94,2810,1174,3984
2017,11,Suiza,787,1132,72,41,2032,170,2202
2017,11,Austria,527,869,93,33,1522,220,1742
2017,11,Rusia,543,846,520,77,1986,1334,3320
2017,11,Países del Este,456,2202,858,318,3834,798,4632
2017,11,Resto de Europa,455,1379,452,147,2433,1291,3724
2017,11,USA,188,104,24,27,343,40,383
2017,11,Resto de América,55,90,29,14,188,28,216
2017,11,Resto del Mundo,440,821,15,16,1292,191,1483
2017,11,TOTAL,24313,64891,13126,4933,107263,39172,146435
2017,12,España,3424,6543,973,274,11214,1779,12993
2017,12,Holanda,615,2663,569,150,3997,1049,5046
2017,12,Bélgica,1585,4019,424,124,6152,745,6897
2017,12,Alemania,3185,8277,2343,82,13887,3806,17693
2017,12,Francia,524,1791,137,36,2488,1153,3641
2017,12,Reino Unido,9745,23978,4280,2237,40240,20993,61233
2017,12,Irlanda,390,796,167,123,1476,763,2239
2017,12,Italia,435,2751,456,129,3771,1186,4957
2017,12,Suecia,530,3948,924,387,5789,2032,7821
2017,12,Noruega,202,906,290,197,1595,757,2352
2017,12,Dinamarca,139,1639,564,412,2754,813,3567
2017,12,Finlandia,485,2019,310,186,3000,1546,4546
2017,12,Suiza,537,816,85,36,1474,219,1693
2017,12,Austria,230,614,38,1,883,189,1072
2017,12,Rusia,466,687,536,77,1766,1350,3116
2017,12,Países del Este,471,2337,676,179,3663,917,4580
2017,12,Resto de Europa,404,1688,526,261,2879,1387,4266
2017,12,USA,231,155,14,18,418,82,500
2017,12,Resto de América,147,71,34,12,264,92,356
2017,12,Resto del Mundo,460,1071,83,71,1685,575,2260
2017,12,TOTAL,24205,66769,13429,4992,109395,41433,150828
2017,13,España,35055,102278,16563,6219,160115,30473,190588
2017,13,Holanda,8539,36564,9130,1420,55653,17830,73483
2017,13,Bélgica,19996,44363,4286,849,69494,7642,77136
2017,13,Alemania,39957,112519,37062,1789,191327,49882,241209
2017,13,Francia,6743,25278,3315,1182,36518,13408,49926
2017,13,Reino Unido,137923,328685,59406,22343,548357,270310,818667
2017,13,Irlanda,5297,11175,2582,2113,21167,11616,32783
2017,13,Italia,3871,29410,5087,1232,39600,13276,52876
2017,13,Suecia,3630,27484,5624,3805,40543,9400,49943
2017,13,Noruega,1279,7373,2444,1809,12905,5881,18786
2017,13,Dinamarca,1405,15535,4501,6960,28401,7701,36102
2017,13,Finlandia,2063,11472,1947,563,16045,6554,22599
2017,13,Suiza,8686,12366,1032,292,22376,2486,24862
2017,13,Austria,3724,8476,660,170,13030,2461,15491
2017,13,Rusia,7838,10488,5759,1107,25192,17061,42253
2017,13,Países del Este,4949,26846,6504,2113,40412,10199,50611
2017,13,Resto de Europa,8804,27091,8029,2111,46035,15572,61607
2017,13,USA,2071,1374,168,186,3799,1052,4851
2017,13,Resto de América,952,1182,602,180,2916,914,3830
2017,13,Resto del Mundo,5491,7502,601,519,14113,4684,18797
2017,13,TOTAL,308273,847461,175302,56962,1387998,498402,1886400
2018,1,España,1149,3729,655,245,5778,1211,6989
2018,1,Holanda,653,2314,574,108,3649,978,4627
2018,1,Bélgica,1682,3937,376,48,6043,651,6694
2018,1,Alemania,2974,8596,2471,327,14368,2038,16406
2018,1,Francia,599,2114,174,115,3002,967,3969
2018,1,Reino Unido,9611,22860,3845,1990,38306,18266,56572
2018,1,Irlanda,522,998,190,162,1872,730,2602
2018,1,Italia,397,3097,455,159,4108,1105,5213
2018,1,Suecia,764,3791,806,355,5716,1603,7319
2018,1,Noruega,182,844,359,170,1555,1062,2617
2018,1,Dinamarca,257,2180,770,570,3777,1165,4942
2018,1,Finlandia,294,1685,325,102,2406,1133,3539
2018,1,Suiza,481,654,178,43,1356,161,1517
2018,1,Austria,214,669,73,11,967,155,1122
2018,1,Rusia,677,855,697,91,2320,1258,3578
2018,1,Países del Este,505,1952,522,211,3190,1029,4219
2018,1,Resto de Europa,413,1432,398,156,2399,1951,4350
2018,1,USA,113,74,12,20,219,88,307
2018,1,Resto de América,96,64,29,12,201,67,268
2018,1,Resto del Mundo,368,922,95,38,1423,395,1818
2018,1,TOTAL,21951,62767,13004,4933,102655,36013,138668
2018,2,España,1450,2916,694,260,5320,1340,6660
2018,2,Holanda,971,2822,570,310,4673,1260,5933
2018,2,Bélgica,1886,4117,436,90,6529,563,7092
2018,2,Alemania,3525,8356,2415,143,14439,2289,16728
2018,2,Francia,773,2531,250,193,3747,1497,5244
2018,2,Reino Unido,12187,24126,3545,2297,42155,17215,59370
2018,2,Irlanda,502,981,108,196,1787,758,2545
2018,2,Italia,296,2799,317,133,3545,953,4498
2018,2,Suecia,704,3168,718,297,4887,1623,6510
2018,2,Noruega,458,1277,355,245,2335,922,3257
2018,2,Dinamarca,328,2414,809,648,4199,1196,5395
2018,2,Finlandia,515,1816,301,183,2815,1283,4098
2018,2,Suiza,488,743,154,43,1428,118,1546
2018,2,Austria,268,755,60,23,1106,138,1244
2018,2,Rusia,195,443,398,36,1072,629,1701
2018,2,Países del Este,348,2222,586,194,3350,745,4095
2018,2,Resto de Europa,479,1163,357,233,2232,1466,3698
2018,2,USA,183,88,12,21,304,37,341
2018,2,Resto de América,87,71,25,17,200,57,257
2018,2,Resto del Mundo,337,991,123,47,1498,428,1926
2018,2,TOTAL,25980,63799,12233,5609,107621,34517,142138
2018,3,España,3700,6526,1084,700,12010,2788,14798
2018,3,Holanda,737,2472,678,72,3959,1100,5059
2018,3,Bélgica,1999,3989,416,178,6582,847,7429
2018,3,Alemania,3980,9430,3428,126,16964,4351,21315
2018,3,Francia,664,2762,189,103,3718,1243,4961
2018,3,Reino Unido,13181,27718,4354,3226,48479,21404,69883
2018,3,Irlanda,688,1236,205,212,2341,900,3241
2018,3,Italia,554,2544,414,126,3638,844,4482
2018,3,Suecia,510,3144,751,209,4614,1650,6264
2018,3,Noruega,199,903,358,234,1694,745,2439
2018,3,Dinamarca,315,2497,857,327,3996,1168,5164
2018,3,Finlandia,337,1800,470,107,2714,1194,3908
2018,3,Suiza,442,907,104,19,1472,129,1601
2018,3,Austria,290,579,53,21,943,164,1107
2018,3,Rusia,358,463,313,77,1211,989,2200
2018,3,Países del Este,458,2266,728,217,3669,795,4464
2018,3,Resto de Europa,599,1460,513,188,2760,1261,4021
2018,3,USA,223,149,30,82,484,129,613
2018,3,Resto de América,88,76,14,24,202,65,267
2018,3,Resto del Mundo,624,1338,90,72,2124,563,2687
2018,3,TOTAL,29946,72259,15049,6320,123574,42329,165903
2018,4,España,2710,6515,875,623,10723,1465,12188
2018,4,Holanda,1163,3953,692,155,5963,2261,8224
2018,4,Bélgica,2181,4603,404,128,7316,717,8033
2018,4,Alemania,2752,8437,3222,219,14630,3145,17775
2018,4,Francia,970,3628,394,148,5140,1259,6399
2018,4,Reino Unido,13132,25856,4367,2364,45719,20268,65987
2018,4,Irlanda,634,1212,153,207,2206,924,3130
2018,4,Italia,477,2618,442,146,3683,751,4434
2018,4,Suecia,237,1910,358,211,2716,922,3638
2018,4,Noruega,65,395,163,75,698,332,1030
2018,4,Dinamarca,52,1099,435,268,1854,376,2230
2018,4,Finlandia,65,601,203,128,997,278,1275
2018,4,Suiza,772,1216,102,45,2135,214,2349
2018,4,Austria,156,501,53,13,723,128,851
2018,4,Rusia,546,700,476,120,1842,1262,3104
2018,4,Países del Este,471,3059,1075,332,4937,1143,6080
2018,4,Resto de Europa,637,1111,732,130,2610,1387,3997
2018,4,USA,252,104,16,36,408,100,508
2018,4,Resto de América,85,67,21,11,184,51,235
2018,4,Resto del Mundo,399,1222,68,43,1732,517,2249
2018,4,TOTAL,27756,68807,14251,5402,116216,37500,153716
2018,5,España,4591,9720,918,405,15634,2939,18573
2018,5,Holanda,1115,3446,674,165,5400,1489,6889
2018,5,Bélgica,1350,3112,302,56,4820,423,5243
2018,5,Alemania,2945,10509,3133,165,16752,3841,20593
2018,5,Francia,646,2380,185,199,3410,624,4034
2018,5,Reino Unido,10444,28060,4442,1972,44918,21860,66778
2018,5,Irlanda,483,1397,225,233,2338,1051,3389
2018,5,Italia,273,1731,430,104,2538,729,3267
2018,5,Suecia,44,194,40,132,410,49,459
2018,5,Noruega,30,37,16,120,203,78,281
2018,5,Dinamarca,32,591,135,249,1007,74,1081
2018,5,Finlandia,9,217,69,3,298,91,389
2018,5,Suiza,566,879,71,52,1568,174,1742
2018,5,Austria,176,416,12,8,612,100,712
2018,5,Rusia,471,682,473,91,1717,1155,2872
2018,5,Países del Este,519,2490,632,200,3841,948,4789
2018,5,Resto de Europa,572,1101,903,82,2658,780,3438
2018,5,USA,197,127,14,28,366,119,485
2018,5,Resto de América,81,127,15,14,237,135,372
2018,5,Resto del Mundo,409,1342,42,29,1822,556,2378
2018,5,TOTAL,24953,68558,12731,4307,110549,37215,147764
2018,6,España,6819,14230,1264,909,23222,3898,27120
2018,6,Holanda,584,2616,544,133,3877,1155,5032
2018,6,Bélgica,1081,3023,395,62,4561,398,4959
2018,6,Alemania,2456,11408,2829,91,16784,3958,20742
2018,6,Francia,431,1573,187,66,2257,581,2838
2018,6,Reino Unido,10359,26409,5200,2852,44820,25548,70368
2018,6,Irlanda,525,1233,275,567,2600,1454,4054
2018,6,Italia,405,1724,484,129,2742,904,3646
2018,6,Suecia,85,484,36,30,635,61,696
2018,6,Noruega,69,278,63,25,435,88,523
2018,6,Dinamarca,30,339,58,326,753,107,860
2018,6,Finlandia,5,33,9,5,52,125,177
2018,6,Suiza,432,1016,66,24,1538,94,1632
2018,6,Austria,161,694,24,15,894,141,1035
2018,6,Rusia,521,796,535,100,1952,1627,3579
2018,6,Países del Este,605,2446,755,271,4077,1496,5573
2018,6,Resto de Europa,554,1617,737,249,3157,1178,4335
2018,6,USA,188,117,12,30,347,161,508
2018,6,Resto de América,89,123,16,20,248,154,402
2018,6,Resto del Mundo,444,1580,38,30,2092,451,2543
2018,6,TOTAL,25843,71739,13527,5934,117043,43579,160622
2018,7,España,8001,14747,1834,1228,25810,5080,30890
2018,7,Holanda,965,3277,798,152,5192,1724,6916
2018,7,Bélgica,1881,3885,594,77,6437,707,7144
2018,7,Alemania,2690,9935,3424,153,16202,4869,21071
2018,7,Francia,693,2012,105,104,2914,1430,4344
2018,7,Reino Unido,12552,25514,4799,2290,45155,25290,70445
2018,7,Irlanda,593,1011,260,510,2374,1747,4121
2018,7,Italia,363,1887,549,100,2899,959,3858
2018,7,Suecia,33,276,156,15,480,108,588
2018,7,Noruega,77,650,105,42,874,215,1089
2018,7,Dinamarca,171,543,104,402,1220,244,1464
2018,7,Finlandia,3,1,6,2,12,57,69
2018,7,Suiza,713,1276,158,49,2196,386,2582
2018,7,Austria,256,711,36,6,1009,283,1292
2018,7,Rusia,703,566,436,113,1818,1220,3038
2018,7,Países del Este,1026,2803,637,241,4707,1060,5767
2018,7,Resto de Europa,635,1623,888,372,3518,996,4514
2018,7,USA,212,141,18,39,410,134,544
2018,7,Resto de América,206,110,15,26,357,163,520
2018,7,Resto del Mundo,898,1716,83,27,2724,767,3491
2018,7,TOTAL,32671,72684,15005,5948,126308,47439,173747
2018,8,España,11033,17854,2747,1964,33598,7103,40701
2018,8,Holanda,1075,3213,785,173,5246,2045,7291
2018,8,Bélgica,1502,3036,672,98,5308,496,5804
2018,8,Alemania,2709,10207,3508,164,16588,4472,21060
2018,8,Francia,978,2158,267,156,3559,1575,5134
2018,8,Reino Unido,12988,26191,4470,2272,45921,27369,73290
2018,8,Irlanda,533,882,263,521,2199,1439,3638
2018,8,Italia,645,2541,781,230,4197,1521,5718
2018,8,Suecia,27,408,10,11,456,49,505
2018,8,Noruega,23,240,4,11,278,20,298
2018,8,Dinamarca,46,328,17,99,490,70,560
2018,8,Finlandia,6,4,0,3,13,34,47
2018,8,Suiza,453,651,55,22,1181,151,1332
2018,8,Austria,261,792,25,13,1091,211,1302
2018,8,Rusia,946,487,342,141,1916,1216,3132
2018,8,Países del Este,897,2540,675,245,4357,1074,5431
2018,8,Resto de Europa,836,2357,635,311,4139,1045,5184
2018,8,USA,262,119,18,31,430,128,558
2018,8,Resto de América,129,81,21,28,259,55,314
2018,8,Resto del Mundo,1133,1553,129,96,2911,907,3818
2018,8,TOTAL,36482,75642,15424,6589,134137,50980,185117
2018,9,España,7247,12487,1538,1069,22341,4440,26781
2018,9,Holanda,1038,2616,504,89,4247,1171,5418
2018,9,Bélgica,1615,2660,448,65,4788,585,5373
2018,9,Alemania,4054,10250,2858,118,17280,3876,21156
2018,9,Francia,629,1713,185,126,2653,1008,3661
2018,9,Reino Unido,13234,24721,5046,2243,45244,22886,68130
2018,9,Irlanda,711,812,233,491,2247,1504,3751
2018,9,Italia,494,1458,496,165,2613,837,3450
2018,9,Suecia,46,413,86,31,576,47,623
2018,9,Noruega,47,345,63,26,481,40,521
2018,9,Dinamarca,24,476,66,242,808,125,933
2018,9,Finlandia,14,169,20,8,211,43,254
2018,9,Suiza,922,901,77,56,1956,246,2202
2018,9,Austria,257,658,44,16,975,139,1114
2018,9,Rusia,776,591,444,116,1927,1173,3100
2018,9,Países del Este,749,2261,671,248,3929,1005,4934
2018,9,Resto de Europa,822,1348,599,237,3006,1109,4115
2018,9,USA,260,75,6,23,364,69,433
2018,9,Resto de América,142,79,39,30,290,87,377
2018,9,Resto del Mundo,810,1098,51,40,1999,415,2414
2018,9,TOTAL,33891,65131,13474,5439,117935,40805,158740
2018,10,España,4722,9418,1000,623,15763,3098,18861
2018,10,Holanda,1204,3372,792,98,5466,1778,7244
2018,10,Bélgica,2803,3573,453,59,6888,761,7649
2018,10,Alemania,4679,10851,3469,114,19113,4284,23397
2018,10,Francia,1156,2470,241,123,3990,1573,5563
2018,10,Reino Unido,17851,29127,5377,2558,54913,26644,81557
2018,10,Irlanda,785,1017,188,275,2265,1220,3485
2018,10,Italia,498,2143,396,108,3145,815,3960
2018,10,Suecia,279,2030,331,174,2814,599,3413
2018,10,Noruega,118,655,359,116,1248,676,1924
2018,10,Dinamarca,100,894,137,407,1538,611,2149
2018,10,Finlandia,149,1024,191,151,1515,605,2120
2018,10,Suiza,1407,1593,118,44,3162,390,3552
2018,10,Austria,382,689,38,24,1133,139,1272
2018,10,Rusia,839,754,604,130,2327,1645,3972
2018,10,Países del Este,730,2145,852,371,4098,1101,5199
2018,10,Resto de Europa,883,1304,681,224,3092,1405,4497
2018,10,USA,302,79,14,7,402,86,488
2018,10,Resto de América,113,77,27,30,247,73,320
2018,10,Resto del Mundo,651,1489,30,29,2199,550,2749
2018,10,TOTAL,39651,74704,15298,5665,135318,48053,183371
2018,11,España,2785,5324,882,211,9202,1672,10874
2018,11,Holanda,707,2351,635,99,3792,1084,4876
2018,11,Bélgica,2231,3217,463,61,5972,567,6539
2018,11,Alemania,4534,10391,3255,130,18310,3604,21914
2018,11,Francia,539,1248,167,53,2007,1066,3073
2018,11,Reino Unido,12273,23288,4342,2693,42596,23945,66541
2018,11,Irlanda,689,829,181,223,1922,1022,2944
2018,11,Italia,519,2177,400,182,3278,944,4222
2018,11,Suecia,491,3079,864,223,4657,872,5529
2018,11,Noruega,225,1085,353,192,1855,977,2832
2018,11,Dinamarca,271,1335,233,378,2217,977,3194
2018,11,Finlandia,424,1705,270,205,2604,1219,3823
2018,11,Suiza,796,1118,96,40,2050,247,2297
2018,11,Austria,415,755,93,15,1278,232,1510
2018,11,Rusia,522,697,815,109,2143,1390,3533
2018,11,Países del Este,471,2296,803,234,3804,1005,4809
2018,11,Resto de Europa,707,898,475,170,2250,1365,3615
2018,11,USA,306,115,16,17,454,82,536
2018,11,Resto de América,51,103,11,18,183,52,235
2018,11,Resto del Mundo,357,1151,29,27,1564,351,1915
2018,11,TOTAL,29313,63162,14383,5280,112138,42673,154811
2018,12,España,4520,6650,1067,355,12592,2154,14746
2018,12,Holanda,863,2130,553,196,3742,1222,4964
2018,12,Bélgica,2305,3817,564,79,6765,777,7542
2018,12,Alemania,3789,7998,3682,172,15641,3809,19450
2018,12,Francia,841,1768,181,71,2861,1295,4156
2018,12,Reino Unido,13380,23942,4643,2297,44262,24368,68630
2018,12,Irlanda,677,952,179,336,2144,822,2966
2018,12,Italia,640,2657,405,235,3937,1162,5099
2018,12,Suecia,371,3523,773,246,4913,1124,6037
2018,12,Noruega,193,895,276,240,1604,764,2368
2018,12,Dinamarca,170,1771,522,312,2775,817,3592
2018,12,Finlandia,460,1819,401,168,2848,1286,4134
2018,12,Suiza,588,741,80,12,1421,151,1572
2018,12,Austria,337,534,54,27,952,221,1173
2018,12,Rusia,638,579,1318,93,2628,1025,3653
2018,12,Países del Este,630,2448,878,328,4284,938,5222
2018,12,Resto de Europa,921,1220,454,272,2867,1263,4130
2018,12,USA,317,187,27,33,564,159,723
2018,12,Resto de América,128,106,33,17,284,101,385
2018,12,Resto del Mundo,658,1699,79,53,2489,674,3163
2018,12,TOTAL,32426,65436,16169,5542,119573,44132,163705
2018,13,España,58727,110116,14558,8592,191993,37188,229181
2018,13,Holanda,11075,34582,7799,1750,55206,17267,72473
2018,13,Bélgica,22516,42969,5523,1001,72009,7492,79501
2018,13,Alemania,41087,116368,37694,1922,197071,44536,241607
2018,13,Francia,8919,26357,2525,1457,39258,14118,53376
2018,13,Reino Unido,151192,307812,54430,29054,542488,275063,817551
2018,13,Irlanda,7342,12560,2460,3933,26295,13571,39866
2018,13,Italia,5561,27376,5569,1817,40323,11524,51847
2018,13,Suecia,3591,22420,4929,1934,32874,8707,41581
2018,13,Noruega,1686,7604,2474,1496,13260,5919,19179
2018,13,Dinamarca,1796,14467,4143,4228,24634,6930,31564
2018,13,Finlandia,2281,10874,2265,1065,16485,7348,23833
2018,13,Suiza,8060,11695,1259,449,21463,2461,23924
2018,13,Austria,3173,7753,565,192,11683,2051,13734
2018,13,Rusia,7192,7613,6851,1217,22873,14589,37462
2018,13,Países del Este,7409,28928,8814,3092,48243,12339,60582
2018,13,Resto de Europa,8058,16634,7372,2624,34688,15206,49894
2018,13,USA,2815,1375,195,367,4752,1292,6044
2018,13,Resto de América,1295,1084,266,247,2892,1060,3952
2018,13,Resto del Mundo,7088,16101,857,531,24577,6574,31151
2018,13,TOTAL,360863,824688,170548,66968,1423067,505235,1928302
2019,1,España,2760,4280,808,251,8099,1771,9870
2019,1,Holanda,708,1811,546,75,3140,1204,4344
2019,1,Bélgica,2207,3495,412,158,6272,673,6945
2019,1,Alemania,3436,7721,2747,104,14008,3059,17067
2019,1,Francia,1073,2015,266,74,3428,1169,4597
2019,1,Reino Unido,12954,23284,3881,2041,42160,21786,63946
2019,1,Irlanda,836,996,199,224,2255,803,3058
2019,1,Italia,595,2847,485,270,4197,1274,5471
2019,1,Suecia,720,2871,702,184,4477,900,5377
2019,1,Noruega,270,967,302,263,1802,895,2697
2019,1,Dinamarca,266,2442,805,653,4166,1093,5259
2019,1,Finlandia,272,1339,329,121,2061,901,2962
2019,1,Suiza,609,564,85,10,1268,139,1407
2019,1,Austria,284,578,117,19,998,204,1202
2019,1,Rusia,1186,793,764,198,2941,1073,4014
2019,1,Países del Este,650,1975,673,379,3677,1242,4919
2019,1,Resto de Europa,759,839,300,242,2140,1182,3322
2019,1,USA,198,90,19,16,323,81,404
2019,1,Resto de América,76,55,53,21,205,51,256
2019,1,Resto del Mundo,531,1129,56,34,1750,460,2210
2019,1,TOTAL,30390,60091,13549,5337,109367,39960,149327
2019,2,España,2770,3958,663,178,7569,1573,9142
2019,2,Holanda,858,2297,689,117,3961,1548,5509
2019,2,Bélgica,2125,3013,423,108,5669,488,6157
2019,2,Alemania,3355,7490,2322,112,13279,2834,16113
2019,2,Francia,1074,2694,303,129,4200,1599,5799
2019,2,Reino Unido,17207,22700,3298,2290,45495,20511,66006
2019,2,Irlanda,996,1070,124,242,2432,931,3363
2019,2,Italia,545,2359,314,216,3434,1154,4588
2019,2,Suecia,423,2673,719,222,4037,915,4952
2019,2,Noruega,308,1092,401,207,2008,828,2836
2019,2,Dinamarca,506,2709,637,651,4503,1306,5809
2019,2,Finlandia,468,1643,380,197,2688,1188,3876
2019,2,Suiza,728,749,183,14,1674,142,1816
2019,2,Austria,495,679,69,7,1250,195,1445
2019,2,Rusia,579,337,180,63,1159,661,1820
2019,2,Países del Este,574,1913,589,297,3373,873,4246
2019,2,Resto de Europa,736,794,327,146,2003,1331,3334
2019,2,USA,388,145,21,29,583,48,631
2019,2,Resto de América,94,69,17,10,190,50,240
2019,2,Resto del Mundo,653,999,47,45,1744,546,2290
2019,2,TOTAL,34882,59383,11706,5280,111251,38721,149972
2019,3,España,3403,5103,1216,381,10103,2421,12524
2019,3,Holanda,1027,2571,779,117,4494,1529,6023
2019,3,Bélgica,2886,4025,528,120,7559,737,8296
2019,3,Alemania,3972,9138,2980,115,16205,3123,19328
2019,3,Francia,957,2209,222,76,3464,1363,4827
2019,3,Reino Unido,17025,26632,4061,3402,51120,25020,76140
2019,3,Irlanda,947,1049,208,363,2567,962,3529
2019,3,Italia,538,2289,371,171,3369,1004,4373
2019,3,Suecia,350,3023,827,244,4444,967,5411
2019,3,Noruega,231,1224,301,239,1995,912,2907
2019,3,Dinamarca,253,2656,697,615,4221,1610,5831
2019,3,Finlandia,401,1871,288,160,2720,1278,3998
2019,3,Suiza,605,684,61,23,1373,168,1541
2019,3,Austria,347,541,38,5,931,106,1037
2019,3,Rusia,601,676,260,132,1669,1189,2858
2019,3,Países del Este,491,1979,710,265,3445,1124,4569
2019,3,Resto de Europa,585,869,307,140,1901,1450,3351
2019,3,USA,415,142,12,22,591,55,646
2019,3,Resto de América,142,31,20,23,216,78,294
2019,3,Resto del Mundo,608,896,48,28,1580,596,2176
2019,3,TOTAL,35784,67608,13934,6641,123967,45692,169659
2019,4,España,5462,10772,2041,1364,19639,4395,24034
2019,4,Holanda,1832,3106,690,153,5781,1935,7716
2019,4,Bélgica,3204,3778,570,80,7632,977,8609
2019,4,Alemania,4642,8505,2680,197,16024,3423,19447
2019,4,Francia,1612,2667,369,167,4815,1380,6195
2019,4,Reino Unido,32283,28140,4367,2435,67225,30055,97280
2019,4,Irlanda,2040,1382,206,418,4046,1096,5142
2019,4,Italia,1641,2595,321,246,4803,953,5756
2019,4,Suecia,242,1397,391,116,2146,524,2670
2019,4,Noruega,241,546,152,112,1051,385,1436
2019,4,Dinamarca,279,1391,407,140,2217,404,2621
2019,4,Finlandia,194,854,189,54,1291,281,1572
2019,4,Suiza,1215,682,184,53,2134,220,2354
2019,4,Austria,554,500,53,22,1129,137,1266
2019,4,Rusia,1577,730,478,238,3023,1375,4398
2019,4,Países del Este,759,2157,729,363,4008,864,4872
2019,4,Resto de Europa,895,985,440,232,2552,1788,4340
2019,4,USA,698,191,24,50,963,137,1100
2019,4,Resto de América,104,76,18,30,228,51,279
2019,4,Resto del Mundo,951,1213,70,56,2290,747,3037
2019,4,TOTAL,60425,71667,14379,6526,152997,51127,204124
2019,5,España,6216,12189,1759,2505,22669,6047,28716
2019,5,Holanda,947,2339,511,78,3875,1449,5324
2019,5,Bélgica,2042,2668,416,108,5234,498,5732
2019,5,Alemania,3418,10065,2574,185,16242,2988,19230
2019,5,Francia,1069,2492,433,525,4519,1326,5845
2019,5,Reino Unido,16516,31131,4982,1563,54192,30084,84276
2019,5,Irlanda,1004,1416,293,37,2750,1114,3864
2019,5,Italia,610,1683,439,138,2870,899,3769
2019,5,Suecia,69,100,50,25,244,295,539
2019,5,Noruega,38,45,47,7,137,174,311
2019,5,Dinamarca,53,354,125,1799,2331,120,2451
2019,5,Finlandia,15,144,30,13,202,74,276
2019,5,Suiza,655,495,70,36,1256,157,1413
2019,5,Austria,218,458,24,36,736,119,855
2019,5,Rusia,908,768,541,308,2525,1437,3962
2019,5,Países del Este,742,2398,1059,406,4605,1346,5951
2019,5,Resto de Europa,606,1077,754,315,2752,1598,4350
2019,5,USA,350,113,23,0,486,266,752
2019,5,Resto de América,211,148,46,49,454,107,561
2019,5,Resto del Mundo,606,1063,81,33,1783,606,2389
2019,5,TOTAL,36293,71146,14257,8166,129862,50704,180566
2019,6,España,7891,15215,1951,1531,26588,6212,32800
2019,6,Holanda,775,1976,390,6,3147,1272,4419
2019,6,Bélgica,1624,2774,703,6,5107,627,5734
2019,6,Alemania,3607,10084,2728,83,16502,3956,20458
2019,6,Francia,722,1610,190,167,2689,1646,4335
2019,6,Reino Unido,12589,28082,5045,805,46521,27465,73986
2019,6,Irlanda,870,1278,369,14,2531,1639,4170
2019,6,Italia,333,1695,372,67,2467,938,3405
2019,6,Suecia,50,500,19,1,570,388,958
2019,6,Noruega,57,236,14,2,309,283,592
2019,6,Dinamarca,56,370,13,1909,2348,157,2505
2019,6,Finlandia,17,17,4,0,38,98,136
2019,6,Suiza,662,491,53,12,1218,176,1394
2019,6,Austria,242,616,21,3,882,112,994
2019,6,Rusia,930,723,761,58,2472,1714,4186
2019,6,Países del Este,873,2383,901,174,4331,1463,5794
2019,6,Resto de Europa,524,2128,709,75,3436,1688,5124
2019,6,USA,360,164,44,2,570,213,783
2019,6,Resto de América,59,106,33,32,230,112,342
2019,6,Resto del Mundo,539,1003,71,13,1626,765,2391
2019,6,TOTAL,32780,71451,14391,4960,123582,50924,174506
2019,7,España,7925,16916,1953,645,27439,8031,35470
2019,7,Holanda,1081,2957,830,10,4878,1839,6717
2019,7,Bélgica,2411,3238,665,68,6382,769,7151
2019,7,Alemania,2718,8906,2771,106,14501,4163,18664
2019,7,Francia,787,1688,284,36,2795,2181,4976
2019,7,Reino Unido,15673,25420,5550,2217,48860,23359,72219
2019,7,Irlanda,898,1230,285,629,3042,1503,4545
2019,7,Italia,423,1907,449,149,2928,946,3874
2019,7,Suecia,154,278,85,0,517,230,747
2019,7,Noruega,94,697,96,6,893,373,1266
2019,7,Dinamarca,190,523,46,119,878,259,1137
2019,7,Finlandia,4,8,9,4,25,19,44
2019,7,Suiza,847,895,84,20,1846,326,2172
2019,7,Austria,354,829,40,4,1227,219,1446
2019,7,Rusia,1438,693,552,85,2768,1548,4316
2019,7,Países del Este,1092,2350,963,129,4534,1045,5579
2019,7,Resto de Europa,825,1660,683,109,3277,1398,4675
2019,7,USA,347,92,25,8,472,199,671
2019,7,Resto de América,147,101,15,57,320,180,500
2019,7,Resto del Mundo,930,1064,73,120,2187,729,2916
2019,7,TOTAL,38338,71452,15458,4521,129769,49316,179085
2019,8,España,10116,21890,3036,1674,36716,10879,47595
2019,8,Holanda,867,2420,814,29,4130,2038,6168
2019,8,Bélgica,1645,3030,601,44,5320,635,5955
2019,8,Alemania,2402,8315,2675,77,13469,4210,17679
2019,8,Francia,1180,2121,331,130,3762,2689,6451
2019,8,Reino Unido,15825,27057,5510,2220,50612,23222,73834
2019,8,Irlanda,770,951,244,505,2470,1644,4114
2019,8,Italia,622,2369,594,158,3743,1531,5274
2019,8,Suecia,66,375,75,19,535,166,701
2019,8,Noruega,45,248,24,6,323,171,494
2019,8,Dinamarca,40,263,57,145,505,121,626
2019,8,Finlandia,6,3,7,2,18,41,59
2019,8,Suiza,419,440,29,15,903,107,1010
2019,8,Austria,298,788,26,10,1122,204,1326
2019,8,Rusia,1326,754,520,106,2706,1504,4210
2019,8,Países del Este,985,2315,973,90,4363,1173,5536
2019,8,Resto de Europa,1004,1857,645,198,3704,1380,5084
2019,8,USA,290,85,14,17,406,163,569
2019,8,Resto de América,122,136,60,29,347,119,466
2019,8,Resto del Mundo,820,915,70,154,1959,893,2852
2019,8,TOTAL,38848,76332,16305,5628,137113,52890,190003
2019,9,España,6246,13979,1767,734,22726,4787,27513
2019,9,Holanda,779,2163,484,62,3488,1346,4834
2019,9,Bélgica,1723,2634,394,53,4804,506,5310
2019,9,Alemania,3738,8522,2357,91,14708,3640,18348
2019,9,Francia,593,1318,138,87,2136,1758,3894
2019,9,Reino Unido,15018,25438,5116,2043,47615,20628,68243
2019,9,Irlanda,848,1230,222,410,2710,1230,3940
2019,9,Italia,461,1753,382,114,2710,967,3677
2019,9,Suecia,40,440,83,14,577,80,657
2019,9,Noruega,92,353,58,25,528,215,743
2019,9,Dinamarca,30,332,66,313,741,172,913
2019,9,Finlandia,13,156,29,0,198,41,239
2019,9,Suiza,892,726,65,19,1702,252,1954
2019,9,Austria,288,503,32,8,831,125,956
2019,9,Rusia,982,784,618,94,2478,1659,4137
2019,9,Países del Este,632,2079,1007,143,3861,1319,5180
2019,9,Resto de Europa,758,1470,550,195,2973,984,3957
2019,9,USA,250,100,10,11,371,88,459
2019,9,Resto de América,118,132,34,22,306,127,433
2019,9,Resto del Mundo,430,1148,44,19,1641,581,2222
2019,9,TOTAL,33931,65260,13456,4457,117104,40505,157609
2019,10,España,5167,10263,1128,947,17505,4429,21934
2019,10,Holanda,1346,3088,700,140,5274,1869,7143
2019,10,Bélgica,2960,3120,309,48,6437,624,7061
2019,10,Alemania,3937,9242,2549,58,15786,3774,19560
2019,10,Francia,1153,2414,339,78,3984,1788,5772
2019,10,Reino Unido,19458,29997,5292,2668,57415,20672,78087
2019,10,Irlanda,1211,1241,260,280,2992,1297,4289
2019,10,Italia,418,1916,429,62,2825,1030,3855
2019,10,Suecia,268,2290,452,212,3222,744,3966
2019,10,Noruega,157,644,310,135,1246,745,1991
2019,10,Dinamarca,217,1219,256,220,1912,617,2529
2019,10,Finlandia,291,1499,235,63,2088,818,2906
2019,10,Suiza,1482,1225,89,24,2820,313,3133
2019,10,Austria,367,552,30,11,960,145,1105
2019,10,Rusia,1040,892,617,106,2655,1941,4596
2019,10,Países del Este,628,2597,1070,151,4446,1423,5869
2019,10,Resto de Europa,919,1291,828,185,3223,1163,4386
2019,10,USA,261,99,6,107,473,97,570
2019,10,Resto de América,131,111,22,6,270,92,362
2019,10,Resto del Mundo,1053,930,50,23,2056,650,2706
2019,10,TOTAL,42464,74630,14971,5524,137589,44231,181820
2019,11,España,4125,6920,846,282,12173,3223,15396
2019,11,Holanda,885,2332,593,51,3861,1141,5002
2019,11,Bélgica,2578,3003,406,48,6035,702,6737
2019,11,Alemania,4591,8813,2551,82,16037,3013,19050
2019,11,Francia,844,1636,277,52,2809,1516,4325
2019,11,Reino Unido,15122,23925,3532,2327,44906,19641,64547
2019,11,Irlanda,972,1089,204,211,2476,897,3373
2019,11,Italia,532,2401,383,116,3432,1121,4553
2019,11,Suecia,454,3373,783,290,4900,1187,6087
2019,11,Noruega,301,1112,399,221,2033,1133,3166
2019,11,Dinamarca,216,1743,283,320,2562,1002,3564
2019,11,Finlandia,568,2105,386,137,3196,1195,4391
2019,11,Suiza,903,780,73,22,1778,286,2064
2019,11,Austria,467,834,101,10,1412,283,1695
2019,11,Rusia,772,615,323,47,1757,1440,3197
2019,11,Países del Este,476,2041,1023,112,3652,1097,4749
2019,11,Resto de Europa,918,1069,313,101,2401,1113,3514
2019,11,USA,382,111,9,20,522,105,627
2019,11,Resto de América,117,89,23,7,236,89,325
2019,11,Resto del Mundo,543,748,26,7,1324,494,1818
2019,11,TOTAL,35766,64739,12534,4463,117502,40678,158180
2019,12,España,4627,7131,1044,322,13124,2827,15951
2019,12,Holanda,994,2365,531,56,3946,1267,5213
2019,12,Bélgica,2729,3382,527,72,6710,804,7514
2019,12,Alemania,3492,7182,2292,49,13015,2985,16000
2019,12,Francia,903,1666,192,57,2818,1408,4226
2019,12,Reino Unido,16070,25149,4419,2183,47821,20581,68402
2019,12,Irlanda,2376,1222,194,251,4043,963,5006
2019,12,Italia,684,2507,572,192,3955,1326,5281
2019,12,Suecia,441,4054,728,259,5482,1287,6769
2019,12,Noruega,198,1108,264,350,1920,784,2704
2019,12,Dinamarca,175,2008,496,289,2968,1034,4002
2019,12,Finlandia,470,2174,395,114,3153,1253,4406
2019,12,Suiza,622,697,77,32,1428,262,1690
2019,12,Austria,325,499,39,5,868,199,1067
2019,12,Rusia,733,560,281,76,1650,1048,2698
2019,12,Países del Este,678,2259,852,151,3940,990,4930
2019,12,Resto de Europa,933,1578,421,245,3177,1408,4585
2019,12,USA,475,158,15,25,673,68,741
2019,12,Resto de América,107,122,23,14,266,112,378
2019,12,Resto del Mundo,794,1213,153,61,2221,987,3208
2019,12,TOTAL,37826,67034,13515,4803,123178,41593,164771
2019,13,España,66708,128616,18212,10814,224350,56595,280945
2019,13,Holanda,12099,29425,7557,894,49975,18437,68412
2019,13,Bélgica,28134,38160,5954,913,73161,8040,81201
2019,13,Alemania,43308,103983,31226,1259,179776,41168,220944
2019,13,Francia,11967,24530,3344,1578,41419,19823,61242
2019,13,Reino Unido,205740,316955,55053,26194,603942,283024,886966
2019,13,Irlanda,13768,14154,2808,3584,34314,14079,48393
2019,13,Italia,7402,26321,5111,1899,40733,13143,53876
2019,13,Suecia,3277,21374,4914,1586,31151,7683,38834
2019,13,Noruega,2032,8272,2368,1573,14245,6898,21143
2019,13,Dinamarca,2281,16010,3888,7173,29352,7895,37247
2019,13,Finlandia,2719,11813,2281,865,17678,7187,24865
2019,13,Suiza,9639,8428,1053,280,19400,2548,21948
2019,13,Austria,4239,7377,590,140,12346,2048,14394
2019,13,Rusia,12072,8325,5895,1511,27803,16589,44392
2019,13,Países del Este,8580,26446,10549,2660,48235,13959,62194
2019,13,Resto de Europa,9462,15617,6277,2183,33539,16483,50022
2019,13,USA,4414,1490,222,307,6433,1520,7953
2019,13,Resto de América,1428,1176,364,300,3268,1168,4436
2019,13,Resto del Mundo,8458,12321,789,593,22161,8054,30215
2019,13,TOTAL,457727,820793,168455,66306,1513281,546341,2059622
2020,1,España,2771,4552,773,370,8466,2062,10528
2020,1,Holanda,871,2053,560,61,3545,1311,4856
2020,1,Bélgica,2365,3011,270,70,5716,693,6409
2020,1,Alemania,3400,7297,2142,65,12904,2843,15747
2020,1,Francia,795,2175,230,114,3314,1450,4764
2020,1,Reino Unido,15345,22780,3769,2171,44065,19963,64028
2020,1,Irlanda,1049,1179,201,265,2694,890,3584
2020,1,Italia,601,2557,310,204,3672,1028,4700
2020,1,Suecia,445,3466,675,271,4857,1106,5963
2020,1,Noruega,233,971,229,203,1636,1000,2636
2020,1,Dinamarca,287,2347,588,409,3631,1098,4729
2020,1,Finlandia,380,1224,310,114,2028,960,2988
2020,1,Suiza,510,528,161,8,1207,195,1402
2020,1,Austria,326,616,92,11,1045,279,1324
2020,1,Rusia,1253,893,293,158,2597,1128,3725
2020,1,Países del Este,538,2138,615,181,3472,1061,4533
2020,1,Resto de Europa,1157,1050,298,247,2752,1303,4055
2020,1,USA,285,87,14,22,408,52,460
2020,1,Resto de América,102,69,10,30,211,116,327
2020,1,Resto del Mundo,517,927,125,60,1629,612,2241
2020,1,TOTAL,33230,59920,11665,5034,109849,39150,148999
2020,2,España,2809,4612,659,203,8283,2247,10530
2020,2,Holanda,1140,2702,762,95,4699,1528,6227
2020,2,Bélgica,2754,2861,408,78,6101,698,6799
2020,2,Alemania,3845,6853,2314,95,13107,2980,16087
2020,2,Francia,1188,2466,313,115,4082,2456,6538
2020,2,Reino Unido,17842,26559,4147,2077,50625,19779,70404
2020,2,Irlanda,1344,1179,168,312,3003,826,3829
2020,2,Italia,413,1942,324,173,2852,750,3602
2020,2,Suecia,498,3771,662,276,5207,1405,6612
2020,2,Noruega,354,1530,312,248,2444,1318,3762
2020,2,Dinamarca,465,2957,670,383,4475,1266,5741
2020,2,Finlandia,703,1999,326,177,3205,1147,4352
2020,2,Suiza,632,456,153,14,1255,171,1426
2020,2,Austria,543,546,55,0,1144,299,1443
2020,2,Rusia,427,505,159,40,1131,743,1874
2020,2,Países del Este,435,1956,649,144,3184,885,4069
2020,2,Resto de Europa,1007,1194,288,162,2651,1145,3796
2020,2,USA,382,98,12,30,522,75,597
2020,2,Resto de América,100,67,15,4,186,105,291
2020,2,Resto del Mundo,699,1186,44,50,1979,645,2624
2020,2,TOTAL,37580,65439,12440,4676,120135,40468,160603
2020,3,España,1054,1837,326,20,3237,1146,4383
2020,3,Holanda,313,1111,316,0,1740,750,2490
2020,3,Bélgica,864,1246,128,5,2243,302,2545
2020,3,Alemania,1933,4273,1576,10,7792,1706,9498
2020,3,Francia,202,1052,198,1,1453,618,2071
2020,3,Reino Unido,5646,10585,1526,339,18096,7941,26037
2020,3,Irlanda,294,586,48,2,930,327,1257
2020,3,Italia,111,436,47,5,599,242,841
2020,3,Suecia,77,1321,271,351,2020,540,2560
2020,3,Noruega,48,498,228,580,1354,372,1726
2020,3,Dinamarca,198,1176,360,953,2687,815,3502
2020,3,Finlandia,164,820,176,62,1222,434,1656
2020,3,Suiza,140,168,42,0,350,63,413
2020,3,Austria,59,106,7,0,172,72,244
2020,3,Rusia,114,149,58,12,333,289,622
2020,3,Países del Este,157,563,174,3,897,490,1387
2020,3,Resto de Europa,170,312,156,22,660,336,996
2020,3,USA,75,27,2,3,107,34,141
2020,3,Resto de América,50,36,5,0,91,25,116
2020,3,Resto del Mundo,173,284,0,15,472,329,801
2020,3,TOTAL,11842,26586,5644,2383,46455,16831,63286
