año,mes,nacion,4 y 5 estrellas,3 estrellas,2 estrellas,1 estrella,hoteleros,extrahoteleros,total
2009,1,España,4471,2815,2954,606,10846,0,10846
2009,1,Holanda,35,21,34,17,107,0,107
2009,1,Bélgica,41,16,11,3,71,0,71
2009,1,Alemania,71,107,165,72,415,0,415
2009,1,Francia,39,59,35,45,178,0,178
2009,1,Gran Bretaña,73,99,152,31,355,0,355
2009,1,Irlanda,23,6,16,4,49,0,49
2009,1,Italia,31,75,141,47,294,0,294
2009,1,Suecia,8,8,18,1,35,0,35
2009,1,Noruega,11,10,22,3,46,0,46
2009,1,Dinamarca,1,13,21,19,54,0,54
2009,1,Finlandia,1,26,81,7,115,0,115
2009,1,Suiza,6,22,22,11,61,0,61
2009,1,Austria,4,3,24,3,34,0,34
2009,1,Rusia,9,19,35,4,67,0,67
2009,1,Países del Este,22,15,29,9,75,0,75
2009,1,Resto de Europa,21,50,33,24,128,0,128
2009,1,Estados Unidos,22,12,20,1,55,0,55
2009,1,Resto de América,12,82,124,96,314,0,314
2009,1,Resto del Mundo,29,110,99,33,271,0,271
2009,1,TOTAL,4930,3568,4036,1036,13570,0,13570
2009,2,España,4896,3275,3624,908,12703,0,12703
2009,2,Holanda,23,10,22,12,67,0,67
2009,2,Bélgica,4,18,2,13,37,0,37
2009,2,Alemania,74,78,146,64,362,0,362
2009,2,Francia,32,55,85,56,228,0,228
2009,2,Gran Bretaña,64,111,128,19,322,0,322
2009,2,Irlanda,6,18,8,13,45,0,45
2009,2,Italia,17,58,101,47,223,0,223
2009,2,Suecia,3,6,59,0,68,0,68
2009,2,Noruega,6,15,33,0,54,0,54
2009,2,Dinamarca,9,14,42,1,66,0,66
2009,2,Finlandia,3,4,42,1,50,0,50
2009,2,Suiza,7,17,29,11,64,0,64
2009,2,Austria,7,7,14,5,33,0,33
2009,2,Rusia,0,2,19,1,22,0,22
2009,2,Países del Este,8,15,25,21,69,0,69
2009,2,Resto de Europa,13,50,68,16,147,0,147
2009,2,Estados Unidos,33,18,20,5,76,0,76
2009,2,Resto de América,23,69,101,95,288,0,288
2009,2,Resto del Mundo,29,92,92,35,248,0,248
2009,2,TOTAL,5257,3932,4660,1323,15172,0,15172
2009,3,España,4655,3658,3909,712,12934,0,12934
2009,3,Holanda,0,18,25,7,50,0,50
2009,3,Bélgica,15,12,25,11,63,0,63
2009,3,Alemania,33,100,169,64,366,0,366
2009,3,Francia,50,74,99,79,302,0,302
2009,3,Gran Bretaña,34,78,134,25,271,0,271
2009,3,Irlanda,15,18,19,0,52,0,52
2009,3,Italia,43,81,154,31,309,0,309
2009,3,Suecia,6,4,54,1,65,0,65
2009,3,Noruega,1,6,28,5,40,0,40
2009,3,Dinamarca,7,13,24,7,51,0,51
2009,3,Finlandia,4,5,60,3,72,0,72
2009,3,Suiza,15,19,12,3,49,0,49
2009,3,Austria,7,9,32,3,51,0,51
2009,3,Rusia,0,14,22,0,36,0,36
2009,3,Países del Este,0,21,80,9,110,0,110
2009,3,Resto de Europa,38,86,67,16,207,0,207
2009,3,Estados Unidos,30,28,22,8,88,0,88
2009,3,Resto de América,17,64,101,60,242,0,242
2009,3,Resto del Mundo,30,87,151,27,295,0,295
2009,3,TOTAL,5000,4395,5187,1071,15653,0,15653
2009,4,España,3673,2919,3491,712,10795,0,10795
2009,4,Holanda,0,15,21,1,37,0,37
2009,4,Bélgica,5,20,33,4,62,0,62
2009,4,Alemania,46,53,66,53,218,0,218
2009,4,Francia,37,88,93,95,313,0,313
2009,4,Gran Bretaña,24,41,108,9,182,0,182
2009,4,Irlanda,11,15,6,0,32,0,32
2009,4,Italia,29,48,71,16,164,0,164
2009,4,Suecia,2,6,9,6,23,0,23
2009,4,Noruega,6,10,2,0,18,0,18
2009,4,Dinamarca,7,8,14,0,29,0,29
2009,4,Finlandia,0,4,33,3,40,0,40
2009,4,Suiza,25,10,14,10,59,0,59
2009,4,Austria,1,4,18,1,24,0,24
2009,4,Rusia,0,6,41,1,48,0,48
2009,4,Países del Este,0,13,25,30,68,0,68
2009,4,Resto de Europa,21,85,52,17,175,0,175
2009,4,Estados Unidos,32,35,9,3,79,0,79
2009,4,Resto de América,44,190,154,69,457,0,457
2009,4,Resto del Mundo,63,65,104,24,256,0,256
2009,4,TOTAL,4026,3635,4364,1054,13079,0,13079
2009,5,España,4048,3396,3388,624,11456,0,11456
2009,5,Holanda,3,18,26,3,50,0,50
2009,5,Bélgica,23,5,18,3,49,0,49
2009,5,Alemania,38,66,99,23,226,0,226
2009,5,Francia,19,62,64,32,177,0,177
2009,5,Gran Bretaña,25,39,130,6,200,0,200
2009,5,Irlanda,2,4,16,0,22,0,22
2009,5,Italia,4,48,60,22,134,0,134
2009,5,Suecia,5,2,8,0,15,0,15
2009,5,Noruega,3,8,7,3,21,0,21
2009,5,Dinamarca,1,6,6,0,13,0,13
2009,5,Finlandia,0,0,22,0,22,0,22
2009,5,Suiza,19,4,13,4,40,0,40
2009,5,Austria,9,3,7,0,19,0,19
2009,5,Rusia,0,17,21,0,38,0,38
2009,5,Países del Este,42,8,39,19,108,0,108
2009,5,Resto de Europa,19,62,31,6,118,0,118
2009,5,Estados Unidos,18,35,34,0,87,0,87
2009,5,Resto de América,58,96,151,98,403,0,403
2009,5,Resto del Mundo,76,72,94,34,276,0,276
2009,5,TOTAL,4412,3951,4234,877,13474,0,13474
2009,6,España,4267,2978,3267,572,11084,0,11084
2009,6,Holanda,1,5,20,4,30,0,30
2009,6,Bélgica,5,8,9,0,22,0,22
2009,6,Alemania,29,53,47,24,153,0,153
2009,6,Francia,39,40,31,36,146,0,146
2009,6,Gran Bretaña,19,55,58,9,141,0,141
2009,6,Irlanda,0,2,6,0,8,0,8
2009,6,Italia,29,49,85,34,197,0,197
2009,6,Suecia,3,0,9,1,13,0,13
2009,6,Noruega,3,3,4,1,11,0,11
2009,6,Dinamarca,0,1,5,0,6,0,6
2009,6,Finlandia,0,1,4,0,5,0,5
2009,6,Suiza,3,0,14,1,18,0,18
2009,6,Austria,6,1,5,0,12,0,12
2009,6,Rusia,4,12,9,0,25,0,25
2009,6,Países del Este,3,23,32,13,71,0,71
2009,6,Resto de Europa,96,29,52,9,186,0,186
2009,6,Estados Unidos,22,13,29,3,67,0,67
2009,6,Resto de América,61,117,97,52,327,0,327
2009,6,Resto del Mundo,43,72,67,46,228,0,228
2009,6,TOTAL,4633,3462,3850,805,12750,0,12750
2009,7,España,3415,2940,3093,504,9952,0,9952
2009,7,Holanda,27,7,12,9,55,0,55
2009,7,Bélgica,6,9,1,6,22,0,22
2009,7,Alemania,37,26,44,18,125,0,125
2009,7,Francia,50,50,64,29,193,0,193
2009,7,Gran Bretaña,47,72,34,3,156,0,156
2009,7,Irlanda,8,8,13,0,29,0,29
2009,7,Italia,44,70,71,33,218,0,218
2009,7,Suecia,10,0,8,0,18,0,18
2009,7,Noruega,11,6,29,0,46,0,46
2009,7,Dinamarca,8,3,5,3,19,0,19
2009,7,Finlandia,0,2,12,0,14,0,14
2009,7,Suiza,8,8,12,4,32,0,32
2009,7,Austria,1,6,13,5,25,0,25
2009,7,Rusia,2,5,13,0,20,0,20
2009,7,Países del Este,17,14,21,27,79,0,79
2009,7,Resto de Europa,45,39,39,8,131,0,131
2009,7,Estados Unidos,44,25,34,1,104,0,104
2009,7,Resto de América,46,172,140,73,431,0,431
2009,7,Resto del Mundo,31,90,84,16,221,0,221
2009,7,TOTAL,3857,3552,3742,739,11890,0,11890
2009,8,España,2222,1728,1720,346,6016,0,6016
2009,8,Holanda,11,6,12,10,39,0,39
2009,8,Bélgica,14,8,12,7,41,0,41
2009,8,Alemania,22,28,57,21,128,0,128
2009,8,Francia,7,32,137,60,236,0,236
2009,8,Gran Bretaña,35,30,33,5,103,0,103
2009,8,Irlanda,7,2,6,2,17,0,17
2009,8,Italia,34,101,105,39,279,0,279
2009,8,Suecia,1,0,1,0,2,0,2
2009,8,Noruega,2,5,6,0,13,0,13
2009,8,Dinamarca,4,2,1,0,7,0,7
2009,8,Finlandia,0,0,25,0,25,0,25
2009,8,Suiza,9,1,1,1,12,0,12
2009,8,Austria,0,2,4,4,10,0,10
2009,8,Rusia,1,6,22,0,29,0,29
2009,8,Países del Este,7,6,18,6,37,0,37
2009,8,Resto de Europa,7,31,31,6,75,0,75
2009,8,Estados Unidos,22,28,7,0,57,0,57
2009,8,Resto de América,27,158,112,41,338,0,338
2009,8,Resto del Mundo,22,137,125,29,313,0,313
2009,8,TOTAL,2454,2311,2435,577,7777,0,7777
2009,9,España,3481,2789,2574,405,9249,0,9249
2009,9,Holanda,10,18,8,0,36,0,36
2009,9,Bélgica,11,7,9,4,31,0,31
2009,9,Alemania,40,45,87,26,198,0,198
2009,9,Francia,19,87,30,30,166,0,166
2009,9,Gran Bretaña,31,52,35,4,122,0,122
2009,9,Irlanda,9,5,6,10,30,0,30
2009,9,Italia,36,56,59,44,195,0,195
2009,9,Suecia,18,2,2,0,22,0,22
2009,9,Noruega,3,2,4,2,11,0,11
2009,9,Dinamarca,1,9,5,0,15,0,15
2009,9,Finlandia,3,1,11,0,15,0,15
2009,9,Suiza,12,3,13,2,30,0,30
2009,9,Austria,6,2,11,6,25,0,25
2009,9,Rusia,4,9,3,6,22,0,22
2009,9,Países del Este,40,14,18,10,82,0,82
2009,9,Resto de Europa,17,33,72,17,139,0,139
2009,9,Estados Unidos,29,30,23,0,82,0,82
2009,9,Resto de América,30,224,134,60,448,0,448
2009,9,Resto del Mundo,11,63,101,30,205,0,205
2009,9,TOTAL,3811,3451,3205,656,11123,0,11123
2009,10,España,3979,3239,3043,428,10689,0,10689
2009,10,Holanda,16,12,17,9,54,0,54
2009,10,Bélgica,8,8,6,2,24,0,24
2009,10,Alemania,64,53,168,34,319,0,319
2009,10,Francia,39,60,44,26,169,0,169
2009,10,Gran Bretaña,41,83,87,4,215,0,215
2009,10,Irlanda,3,10,9,2,24,0,24
2009,10,Italia,26,48,72,30,176,0,176
2009,10,Suecia,4,7,30,0,41,0,41
2009,10,Noruega,0,2,18,2,22,0,22
2009,10,Dinamarca,0,7,8,1,16,0,16
2009,10,Finlandia,0,0,8,0,8,0,8
2009,10,Suiza,2,23,25,4,54,0,54
2009,10,Austria,2,10,4,9,25,0,25
2009,10,Rusia,3,3,37,0,43,0,43
2009,10,Países del Este,3,20,46,1,70,0,70
2009,10,Resto de Europa,10,49,50,16,125,0,125
2009,10,Estados Unidos,20,16,13,6,55,0,55
2009,10,Resto de América,27,241,151,39,458,0,458
2009,10,Resto del Mundo,23,113,65,21,222,0,222
2009,10,TOTAL,4270,4004,3901,634,12809,0,12809
2009,11,España,3782,3465,3473,446,11166,0,11166
2009,11,Holanda,19,5,19,7,50,0,50
2009,11,Bélgica,8,20,24,4,56,0,56
2009,11,Alemania,269,89,156,50,564,0,564
2009,11,Francia,36,52,47,59,194,0,194
2009,11,Gran Bretaña,48,91,99,20,258,0,258
2009,11,Irlanda,4,10,8,4,26,0,26
2009,11,Italia,56,58,65,26,205,0,205
2009,11,Suecia,6,10,21,5,42,0,42
2009,11,Noruega,0,18,25,2,45,0,45
2009,11,Dinamarca,2,4,8,2,16,0,16
2009,11,Finlandia,3,7,36,4,50,0,50
2009,11,Suiza,11,12,18,6,47,0,47
2009,11,Austria,9,7,33,7,56,0,56
2009,11,Rusia,8,5,17,4,34,0,34
2009,11,Países del Este,32,15,43,13,103,0,103
2009,11,Resto de Europa,25,46,45,24,140,0,140
2009,11,Estados Unidos,33,24,35,5,97,0,97
2009,11,Resto de América,43,206,220,34,503,0,503
2009,11,Resto del Mundo,25,177,90,46,338,0,338
2009,11,TOTAL,4419,4321,4482,768,13990,0,13990
2009,12,España,3196,2901,3517,415,10029,0,10029
2009,12,Holanda,13,8,66,12,99,0,99
2009,12,Bélgica,16,24,28,28,96,0,96
2009,12,Alemania,68,162,257,59,546,0,546
2009,12,Francia,27,68,78,54,227,0,227
2009,12,Gran Bretaña,78,110,167,30,385,0,385
2009,12,Irlanda,10,14,15,5,44,0,44
2009,12,Italia,59,60,109,44,272,0,272
2009,12,Suecia,3,0,13,5,21,0,21
2009,12,Noruega,7,25,24,0,56,0,56
2009,12,Dinamarca,3,10,17,1,31,0,31
2009,12,Finlandia,15,4,30,1,50,0,50
2009,12,Suiza,7,27,33,24,91,0,91
2009,12,Austria,7,8,27,6,48,0,48
2009,12,Rusia,2,5,14,0,21,0,21
2009,12,Países del Este,13,16,35,11,75,0,75
2009,12,Resto de Europa,31,50,37,12,130,0,130
2009,12,Estados Unidos,24,32,23,5,84,0,84
2009,12,Resto de América,34,216,175,54,479,0,479
2009,12,Resto del Mundo,49,125,102,26,302,0,302
2009,12,TOTAL,3662,3865,4767,792,13086,0,13086
2009,13,España,46085,36103,38053,6678,126919,0,126919
2009,13,Holanda,158,143,282,91,674,0,674
2009,13,Bélgica,156,155,178,85,574,0,574
2009,13,Alemania,791,860,1461,508,3620,0,3620
2009,13,Francia,394,727,807,601,2529,0,2529
2009,13,Gran Bretaña,519,861,1165,165,2710,0,2710
2009,13,Irlanda,98,112,128,40,378,0,378
2009,13,Italia,408,752,1093,413,2666,0,2666
2009,13,Suecia,69,45,232,19,365,0,365
2009,13,Noruega,53,110,202,18,383,0,383
2009,13,Dinamarca,43,90,156,34,323,0,323
2009,13,Finlandia,29,54,364,19,466,0,466
2009,13,Suiza,124,146,206,81,557,0,557
2009,13,Austria,59,62,192,49,362,0,362
2009,13,Rusia,33,103,253,16,405,0,405
2009,13,Países del Este,187,180,411,169,947,0,947
2009,13,Resto de Europa,343,610,577,171,1701,0,1701
2009,13,Estados Unidos,329,296,269,37,931,0,931
2009,13,Resto de América,422,1835,1660,771,4688,0,4688
2009,13,Resto del Mundo,431,1203,1174,367,3175,0,3175
2009,13,TOTAL,50731,44447,48863,10332,154373,0,154373
2010,1,España,3886,2963,2898,363,10110,0,10110
2010,1,Holanda,22,16,45,15,98,0,98
2010,1,Bélgica,10,14,23,10,57,0,57
2010,1,Alemania,53,118,159,52,382,0,382
2010,1,Francia,24,51,118,35,228,0,228
2010,1,Gran Bretaña,194,143,151,29,517,0,517
2010,1,Irlanda,8,22,22,6,58,0,58
2010,1,Italia,35,89,128,30,282,0,282
2010,1,Suecia,2,13,27,5,47,0,47
2010,1,Noruega,6,8,6,4,24,0,24
2010,1,Dinamarca,3,18,11,6,38,0,38
2010,1,Finlandia,1,30,44,2,77,0,77
2010,1,Suiza,6,30,35,4,75,0,75
2010,1,Austria,4,14,17,0,35,0,35
2010,1,Rusia,3,18,12,5,38,0,38
2010,1,Países del Este,0,36,30,23,89,0,89
2010,1,Resto de Europa,4,47,62,16,129,0,129
2010,1,Estados Unidos,11,58,19,12,100,0,100
2010,1,Resto de América,99,207,162,35,503,0,503
2010,1,Resto del Mundo,33,136,98,34,301,0,301
2010,1,TOTAL,4404,4031,4067,686,13188,0,13188
2010,2,España,5030,3605,4038,789,13462,0,13462
2010,2,Holanda,10,18,105,20,153,0,153
2010,2,Bélgica,15,13,12,5,45,0,45
2010,2,Alemania,56,116,150,85,407,0,407
2010,2,Francia,40,106,91,63,300,0,300
2010,2,Gran Bretaña,100,86,144,18,348,0,348
2010,2,Irlanda,12,15,17,8,52,0,52
2010,2,Italia,48,60,147,63,318,0,318
2010,2,Suecia,13,9,63,15,100,0,100
2010,2,Noruega,6,6,37,3,52,0,52
2010,2,Dinamarca,10,22,38,5,75,0,75
2010,2,Finlandia,3,7,53,3,66,0,66
2010,2,Suiza,18,16,12,8,54,0,54
2010,2,Austria,11,10,37,10,68,0,68
2010,2,Rusia,20,37,13,3,73,0,73
2010,2,Países del Este,7,16,40,23,86,0,86
2010,2,Resto de Europa,38,77,50,8,173,0,173
2010,2,Estados Unidos,45,20,36,5,106,0,106
2010,2,Resto de América,34,232,159,58,483,0,483
2010,2,Resto del Mundo,23,167,88,60,338,0,338
2010,2,TOTAL,5539,4638,5330,1252,16759,0,16759
2010,3,España,4654,3375,3606,514,12149,0,12149
2010,3,Holanda,14,2,22,4,42,0,42
2010,3,Bélgica,14,10,17,6,47,0,47
2010,3,Alemania,89,74,154,71,388,0,388
2010,3,Francia,37,56,55,60,208,0,208
2010,3,Gran Bretaña,68,66,101,13,248,0,248
2010,3,Irlanda,9,6,11,7,33,0,33
2010,3,Italia,35,59,91,18,203,0,203
2010,3,Suecia,7,14,18,0,39,0,39
2010,3,Noruega,3,6,5,0,14,0,14
2010,3,Dinamarca,0,8,19,0,27,0,27
2010,3,Finlandia,2,6,40,0,48,0,48
2010,3,Suiza,12,11,14,2,39,0,39
2010,3,Austria,10,9,13,5,37,0,37
2010,3,Rusia,8,19,13,1,41,0,41
2010,3,Países del Este,11,26,27,11,75,0,75
2010,3,Resto de Europa,26,54,33,22,135,0,135
2010,3,Estados Unidos,29,28,69,7,133,0,133
2010,3,Resto de América,14,171,136,38,359,0,359
2010,3,Resto del Mundo,72,88,97,52,309,0,309
2010,3,TOTAL,5114,4088,4541,831,14574,0,14574
2010,4,España,3897,3079,3077,363,10416,0,10416
2010,4,Holanda,22,4,39,6,71,0,71
2010,4,Bélgica,14,5,25,8,52,0,52
2010,4,Alemania,61,50,114,41,266,0,266
2010,4,Francia,32,48,115,43,238,0,238
2010,4,Gran Bretaña,29,71,68,4,172,0,172
2010,4,Irlanda,2,9,17,3,31,0,31
2010,4,Italia,16,49,86,28,179,0,179
2010,4,Suecia,3,7,5,5,20,0,20
2010,4,Noruega,9,1,13,1,24,0,24
2010,4,Dinamarca,5,11,6,0,22,0,22
2010,4,Finlandia,2,5,14,4,25,0,25
2010,4,Suiza,5,7,24,6,42,0,42
2010,4,Austria,5,11,1,0,17,0,17
2010,4,Rusia,1,13,14,4,32,0,32
2010,4,Países del Este,1,31,34,10,76,0,76
2010,4,Resto de Europa,7,34,47,13,101,0,101
2010,4,Estados Unidos,31,90,26,0,147,0,147
2010,4,Resto de América,8,129,139,30,306,0,306
2010,4,Resto del Mundo,86,128,116,28,358,0,358
2010,4,TOTAL,4236,3782,3980,597,12595,0,12595
2010,5,España,3665,3226,3308,430,10629,0,10629
2010,5,Holanda,22,1,24,6,53,0,53
2010,5,Bélgica,21,13,24,4,62,0,62
2010,5,Alemania,36,47,95,14,192,0,192
2010,5,Francia,17,39,54,32,142,0,142
2010,5,Gran Bretaña,30,52,62,0,144,0,144
2010,5,Irlanda,0,2,18,0,20,0,20
2010,5,Italia,14,39,83,14,150,0,150
2010,5,Suecia,9,8,9,3,29,0,29
2010,5,Noruega,5,9,8,3,25,0,25
2010,5,Dinamarca,1,2,7,0,10,0,10
2010,5,Finlandia,4,2,16,0,22,0,22
2010,5,Suiza,6,10,18,0,34,0,34
2010,5,Austria,8,8,1,0,17,0,17
2010,5,Rusia,2,18,13,0,33,0,33
2010,5,Países del Este,3,9,32,8,52,0,52
2010,5,Resto de Europa,29,123,44,6,202,0,202
2010,5,Estados Unidos,9,28,34,1,72,0,72
2010,5,Resto de América,4,90,140,23,257,0,257
2010,5,Resto del Mundo,25,119,104,14,262,0,262
2010,5,TOTAL,3910,3845,4094,558,12407,0,12407
2010,6,España,3558,3323,3593,384,10858,0,10858
2010,6,Holanda,13,4,17,1,35,0,35
2010,6,Bélgica,19,8,7,5,39,0,39
2010,6,Alemania,15,40,76,18,149,0,149
2010,6,Francia,11,48,39,16,114,0,114
2010,6,Gran Bretaña,36,72,68,5,181,0,181
2010,6,Irlanda,7,9,11,0,27,0,27
2010,6,Italia,6,49,80,33,168,0,168
2010,6,Suecia,1,4,2,0,7,0,7
2010,6,Noruega,3,2,4,0,9,0,9
2010,6,Dinamarca,0,9,4,1,14,0,14
2010,6,Finlandia,0,2,11,0,13,0,13
2010,6,Suiza,2,20,8,5,35,0,35
2010,6,Austria,0,3,2,0,5,0,5
2010,6,Rusia,4,7,2,3,16,0,16
2010,6,Países del Este,3,18,24,1,46,0,46
2010,6,Resto de Europa,1,91,55,9,156,0,156
2010,6,Estados Unidos,5,68,30,3,106,0,106
2010,6,Resto de América,6,228,155,14,403,0,403
2010,6,Resto del Mundo,38,141,103,19,301,0,301
2010,6,TOTAL,3728,4146,4291,517,12682,0,12682
2010,7,España,3241,2315,2871,322,8749,0,8749
2010,7,Holanda,15,13,26,0,54,0,54
2010,7,Bélgica,15,13,5,5,38,0,38
2010,7,Alemania,27,44,82,13,166,0,166
2010,7,Francia,30,48,34,33,145,0,145
2010,7,Gran Bretaña,27,48,39,11,125,0,125
2010,7,Irlanda,1,3,4,9,17,0,17
2010,7,Italia,24,76,58,35,193,0,193
2010,7,Suecia,6,4,2,0,12,0,12
2010,7,Noruega,2,13,8,0,23,0,23
2010,7,Dinamarca,2,2,19,0,23,0,23
2010,7,Finlandia,0,5,26,1,32,0,32
2010,7,Suiza,7,13,7,3,30,0,30
2010,7,Austria,4,4,11,3,22,0,22
2010,7,Rusia,2,6,6,0,14,0,14
2010,7,Países del Este,0,5,23,16,44,0,44
2010,7,Resto de Europa,11,46,26,5,88,0,88
2010,7,Estados Unidos,14,67,40,1,122,0,122
2010,7,Resto de América,11,243,148,28,430,0,430
2010,7,Resto del Mundo,35,142,85,22,284,0,284
2010,7,TOTAL,3474,3110,3520,507,10611,0,10611
2010,8,España,3210,1931,2110,244,7495,0,7495
2010,8,Holanda,0,2,13,0,15,0,15
2010,8,Bélgica,21,11,14,3,49,0,49
2010,8,Alemania,50,36,76,14,176,0,176
2010,8,Francia,66,49,62,38,215,0,215
2010,8,Gran Bretaña,45,37,53,0,135,0,135
2010,8,Irlanda,6,1,6,3,16,0,16
2010,8,Italia,91,66,218,47,422,0,422
2010,8,Suecia,4,18,6,0,28,0,28
2010,8,Noruega,4,15,1,0,20,0,20
2010,8,Dinamarca,0,21,4,0,25,0,25
2010,8,Finlandia,0,8,49,0,57,0,57
2010,8,Suiza,10,21,12,1,44,0,44
2010,8,Austria,19,5,6,0,30,0,30
2010,8,Rusia,8,12,12,0,32,0,32
2010,8,Países del Este,0,8,15,4,27,0,27
2010,8,Resto de Europa,19,32,44,14,109,0,109
2010,8,Estados Unidos,8,20,22,0,50,0,50
2010,8,Resto de América,25,237,152,22,436,0,436
2010,8,Resto del Mundo,140,185,68,15,408,0,408
2010,8,TOTAL,3726,2715,2943,405,9789,0,9789
2010,9,España,3139,2449,2873,281,8742,0,8742
2010,9,Holanda,17,3,24,1,45,0,45
2010,9,Bélgica,5,20,18,1,44,0,44
2010,9,Alemania,37,71,131,25,264,0,264
2010,9,Francia,15,25,45,25,110,0,110
2010,9,Gran Bretaña,13,51,54,3,121,0,121
2010,9,Irlanda,3,1,4,0,8,0,8
2010,9,Italia,8,93,65,27,193,0,193
2010,9,Suecia,0,7,7,15,29,0,29
2010,9,Noruega,0,1,4,0,5,0,5
2010,9,Dinamarca,1,3,3,3,10,0,10
2010,9,Finlandia,0,0,29,0,29,0,29
2010,9,Suiza,3,18,27,15,63,0,63
2010,9,Austria,0,3,9,1,13,0,13
2010,9,Rusia,1,3,4,0,8,0,8
2010,9,Países del Este,3,15,22,6,46,0,46
2010,9,Resto de Europa,8,34,80,10,132,0,132
2010,9,Estados Unidos,4,37,16,0,57,0,57
2010,9,Resto de América,12,199,131,14,356,0,356
2010,9,Resto del Mundo,31,59,82,9,181,0,181
2010,9,TOTAL,3300,3092,3628,436,10456,0,10456
2010,10,España,3880,3436,3670,309,11295,0,11295
2010,10,Holanda,6,11,34,3,54,0,54
2010,10,Bélgica,33,10,20,10,73,0,73
2010,10,Alemania,78,89,228,42,437,0,437
2010,10,Francia,19,50,70,32,171,0,171
2010,10,Gran Bretaña,37,65,88,3,193,0,193
2010,10,Irlanda,8,4,8,3,23,0,23
2010,10,Italia,27,74,76,28,205,0,205
2010,10,Suecia,2,3,34,0,39,0,39
2010,10,Noruega,4,16,29,0,49,0,49
2010,10,Dinamarca,6,5,23,3,37,0,37
2010,10,Finlandia,0,5,18,0,23,0,23
2010,10,Suiza,31,25,46,38,140,0,140
2010,10,Austria,0,13,25,3,41,0,41
2010,10,Rusia,10,7,35,4,56,0,56
2010,10,Países del Este,6,4,54,18,82,0,82
2010,10,Resto de Europa,83,57,57,11,208,0,208
2010,10,Estados Unidos,14,36,41,3,94,0,94
2010,10,Resto de América,10,124,181,30,345,0,345
2010,10,Resto del Mundo,41,145,104,30,320,0,320
2010,10,TOTAL,4295,4179,4841,570,13885,0,13885
2010,11,España,4049,3521,3988,384,11942,0,11942
2010,11,Holanda,12,21,33,15,81,0,81
2010,11,Bélgica,50,14,27,14,105,0,105
2010,11,Alemania,103,104,217,37,461,0,461
2010,11,Francia,56,63,98,49,266,0,266
2010,11,Gran Bretaña,64,92,135,8,299,0,299
2010,11,Irlanda,12,12,23,4,51,0,51
2010,11,Italia,47,114,99,33,293,0,293
2010,11,Suecia,6,5,50,0,61,0,61
2010,11,Noruega,0,23,14,1,38,0,38
2010,11,Dinamarca,6,11,28,0,45,0,45
2010,11,Finlandia,19,10,61,3,93,0,93
2010,11,Suiza,21,14,46,1,82,0,82
2010,11,Austria,4,4,12,5,25,0,25
2010,11,Rusia,12,9,16,5,42,0,42
2010,11,Países del Este,72,4,55,20,151,0,151
2010,11,Resto de Europa,10,62,98,11,181,0,181
2010,11,Estados Unidos,21,23,29,6,79,0,79
2010,11,Resto de América,0,142,127,29,298,0,298
2010,11,Resto del Mundo,118,237,97,28,480,0,480
2010,11,TOTAL,4682,4485,5253,653,15073,0,15073
2010,12,España,3304,2908,3218,527,9957,0,9957
2010,12,Holanda,18,10,55,24,107,0,107
2010,12,Bélgica,20,22,24,8,74,0,74
2010,12,Alemania,108,225,231,54,618,0,618
2010,12,Francia,44,61,109,127,341,0,341
2010,12,Gran Bretaña,68,115,213,27,423,0,423
2010,12,Irlanda,16,19,26,5,66,0,66
2010,12,Italia,46,55,135,54,290,0,290
2010,12,Suecia,9,9,32,0,50,0,50
2010,12,Noruega,2,28,25,3,58,0,58
2010,12,Dinamarca,8,16,26,0,50,0,50
2010,12,Finlandia,8,12,49,5,74,0,74
2010,12,Suiza,13,34,21,14,82,0,82
2010,12,Austria,8,9,14,3,34,0,34
2010,12,Rusia,3,9,26,0,38,0,38
2010,12,Países del Este,11,17,40,8,76,0,76
2010,12,Resto de Europa,11,147,76,0,234,0,234
2010,12,Estados Unidos,33,34,78,5,150,0,150
2010,12,Resto de América,20,207,173,32,432,0,432
2010,12,Resto del Mundo,28,90,146,30,294,0,294
2010,12,TOTAL,3778,4027,4717,926,13448,0,13448
2010,13,España,45513,36131,39250,4910,125804,0,125804
2010,13,Holanda,171,105,437,95,808,0,808
2010,13,Bélgica,237,153,216,79,685,0,685
2010,13,Alemania,713,1014,1713,466,3906,0,3906
2010,13,Francia,391,644,890,553,2478,0,2478
2010,13,Gran Bretaña,711,898,1176,121,2906,0,2906
2010,13,Irlanda,84,103,167,48,402,0,402
2010,13,Italia,397,823,1266,410,2896,0,2896
2010,13,Suecia,62,101,255,43,461,0,461
2010,13,Noruega,44,128,154,15,341,0,341
2010,13,Dinamarca,42,128,188,18,376,0,376
2010,13,Finlandia,39,92,410,18,559,0,559
2010,13,Suiza,134,219,270,97,720,0,720
2010,13,Austria,73,93,148,30,344,0,344
2010,13,Rusia,74,158,166,25,423,0,423
2010,13,Países del Este,117,189,396,148,850,0,850
2010,13,Resto de Europa,247,804,672,125,1848,0,1848
2010,13,Estados Unidos,224,509,440,43,1216,0,1216
2010,13,Resto de América,243,2209,1803,353,4608,0,4608
2010,13,Resto del Mundo,670,1637,1188,341,3836,0,3836
2010,13,TOTAL,50186,46138,51205,7938,155467,0,155467
2011,1,España,3715,2848,2714,346,9623,0,9623
2011,1,Holanda,19,10,43,10,82,0,82
2011,1,Bélgica,27,20,17,16,80,0,80
2011,1,Alemania,134,140,158,44,476,0,476
2011,1,Francia,68,70,75,53,266,0,266
2011,1,Gran Bretaña,83,153,170,38,444,0,444
2011,1,Irlanda,4,20,26,10,60,0,60
2011,1,Italia,56,148,130,47,381,0,381
2011,1,Suecia,10,17,43,5,75,0,75
2011,1,Noruega,4,28,21,4,57,0,57
2011,1,Dinamarca,2,12,15,11,40,0,40
2011,1,Finlandia,10,22,48,0,80,0,80
2011,1,Suiza,14,15,36,4,69,0,69
2011,1,Austria,16,7,9,6,38,0,38
2011,1,Rusia,4,10,29,0,43,0,43
2011,1,Países del Este,0,15,63,24,102,0,102
2011,1,Resto de Europa,12,28,86,11,137,0,137
2011,1,Estados Unidos,23,17,14,1,55,0,55
2011,1,Resto de América,8,105,126,32,271,0,271
2011,1,Resto del Mundo,95,47,62,25,229,0,229
2011,1,TOTAL,4304,3732,3885,687,12608,0,12608
2011,2,España,3366,3388,3162,445,10361,0,10361
2011,2,Holanda,0,8,53,13,74,0,74
2011,2,Bélgica,29,15,9,8,61,0,61
2011,2,Alemania,116,170,192,34,512,0,512
2011,2,Francia,64,167,120,91,442,0,442
2011,2,Gran Bretaña,64,175,197,22,458,0,458
2011,2,Irlanda,8,20,33,6,67,0,67
2011,2,Italia,49,107,115,43,314,0,314
2011,2,Suecia,16,8,81,5,110,0,110
2011,2,Noruega,10,22,43,0,75,0,75
2011,2,Dinamarca,4,32,29,10,75,0,75
2011,2,Finlandia,8,20,45,3,76,0,76
2011,2,Suiza,12,20,24,5,61,0,61
2011,2,Austria,4,12,21,6,43,0,43
2011,2,Rusia,0,5,36,5,46,0,46
2011,2,Países del Este,12,3,83,6,104,0,104
2011,2,Resto de Europa,50,25,70,16,161,0,161
2011,2,Estados Unidos,19,33,30,4,86,0,86
2011,2,Resto de América,8,38,118,30,194,0,194
2011,2,Resto del Mundo,25,193,139,22,379,0,379
2011,2,TOTAL,3864,4461,4600,774,13699,0,13699
2011,3,España,4054,3539,4091,500,12184,0,12184
2011,3,Holanda,18,0,38,19,75,0,75
2011,3,Bélgica,28,18,24,11,81,0,81
2011,3,Alemania,51,137,240,89,517,0,517
2011,3,Francia,40,135,141,105,421,0,421
2011,3,Gran Bretaña,39,205,198,16,458,0,458
2011,3,Irlanda,5,23,8,11,47,0,47
2011,3,Italia,71,199,209,27,506,0,506
2011,3,Suecia,2,3,44,8,57,0,57
2011,3,Noruega,2,16,20,14,52,0,52
2011,3,Dinamarca,6,10,66,8,90,0,90
2011,3,Finlandia,7,16,97,8,128,0,128
2011,3,Suiza,9,28,19,3,59,0,59
2011,3,Austria,1,13,13,0,27,0,27
2011,3,Rusia,3,8,81,8,100,0,100
2011,3,Países del Este,2,10,101,54,167,0,167
2011,3,Resto de Europa,32,106,108,5,251,0,251
2011,3,Estados Unidos,28,28,29,0,85,0,85
2011,3,Resto de América,21,31,120,30,202,0,202
2011,3,Resto del Mundo,29,243,138,27,437,0,437
2011,3,TOTAL,4448,4768,5785,943,15944,0,15944
2011,4,España,3017,3104,3059,410,9590,0,9590
2011,4,Holanda,25,5,34,19,83,0,83
2011,4,Bélgica,37,20,15,8,80,0,80
2011,4,Alemania,115,121,204,47,487,0,487
2011,4,Francia,23,81,111,33,248,0,248
2011,4,Gran Bretaña,50,62,104,6,222,0,222
2011,4,Irlanda,16,5,9,1,31,0,31
2011,4,Italia,25,81,147,30,283,0,283
2011,4,Suecia,6,9,8,0,23,0,23
2011,4,Noruega,8,14,15,0,37,0,37
2011,4,Dinamarca,35,11,18,4,68,0,68
2011,4,Finlandia,8,8,15,1,32,0,32
2011,4,Suiza,2,36,26,4,68,0,68
2011,4,Austria,12,9,8,3,32,0,32
2011,4,Rusia,8,31,85,4,128,0,128
2011,4,Países del Este,17,30,103,29,179,0,179
2011,4,Resto de Europa,0,67,114,11,192,0,192
2011,4,Estados Unidos,31,45,33,3,112,0,112
2011,4,Resto de América,8,158,152,28,346,0,346
2011,4,Resto del Mundo,35,105,172,38,350,0,350
2011,4,TOTAL,3478,4002,4432,679,12591,0,12591
2011,5,España,3640,3542,3455,481,11118,0,11118
2011,5,Holanda,0,9,26,5,40,0,40
2011,5,Bélgica,10,18,20,8,56,0,56
2011,5,Alemania,35,52,98,28,213,0,213
2011,5,Francia,25,56,83,25,189,0,189
2011,5,Gran Bretaña,31,38,120,6,195,0,195
2011,5,Irlanda,2,8,15,3,28,0,28
2011,5,Italia,33,33,106,11,183,0,183
2011,5,Suecia,2,4,7,0,13,0,13
2011,5,Noruega,0,0,11,0,11,0,11
2011,5,Dinamarca,8,0,3,3,14,0,14
2011,5,Finlandia,0,4,24,0,28,0,28
2011,5,Suiza,2,9,19,3,33,0,33
2011,5,Austria,0,9,17,3,29,0,29
2011,5,Rusia,4,0,22,4,30,0,30
2011,5,Países del Este,2,2,29,5,38,0,38
2011,5,Resto de Europa,10,2,136,8,156,0,156
2011,5,Estados Unidos,21,22,11,3,57,0,57
2011,5,Resto de América,16,9,120,30,175,0,175
2011,5,Resto del Mundo,83,331,104,34,552,0,552
2011,5,TOTAL,3924,4148,4426,660,13158,0,13158
2011,6,España,3447,2972,3376,534,10329,0,10329
2011,6,Holanda,14,6,11,0,31,0,31
2011,6,Bélgica,6,8,11,1,26,0,26
2011,6,Alemania,39,30,88,37,194,0,194
2011,6,Francia,16,15,65,34,130,0,130
2011,6,Gran Bretaña,25,81,46,4,156,0,156
2011,6,Irlanda,4,5,7,0,16,0,16
2011,6,Italia,17,59,96,42,214,0,214
2011,6,Suecia,2,7,11,0,20,0,20
2011,6,Noruega,0,3,8,0,11,0,11
2011,6,Dinamarca,12,5,11,5,33,0,33
2011,6,Finlandia,8,0,16,3,27,0,27
2011,6,Suiza,4,5,12,5,26,0,26
2011,6,Austria,4,0,1,8,13,0,13
2011,6,Rusia,0,6,20,0,26,0,26
2011,6,Países del Este,6,15,23,68,112,0,112
2011,6,Resto de Europa,14,54,74,4,146,0,146
2011,6,Estados Unidos,21,28,24,3,76,0,76
2011,6,Resto de América,14,146,66,61,287,0,287
2011,6,Resto del Mundo,23,79,44,48,194,0,194
2011,6,TOTAL,3676,3524,4010,857,12067,0,12067
2011,7,España,3307,2672,3448,495,9922,0,9922
2011,7,Holanda,2,10,22,4,38,0,38
2011,7,Bélgica,8,2,12,5,27,0,27
2011,7,Alemania,31,47,109,30,217,0,217
2011,7,Francia,58,85,63,64,270,0,270
2011,7,Gran Bretaña,85,40,57,5,187,0,187
2011,7,Irlanda,2,7,12,0,21,0,21
2011,7,Italia,54,85,86,38,263,0,263
2011,7,Suecia,2,5,9,0,16,0,16
2011,7,Noruega,10,3,2,0,15,0,15
2011,7,Dinamarca,10,0,3,1,14,0,14
2011,7,Finlandia,4,0,26,2,32,0,32
2011,7,Suiza,2,7,2,3,14,0,14
2011,7,Austria,8,2,6,0,16,0,16
2011,7,Rusia,4,17,56,3,80,0,80
2011,7,Países del Este,10,5,23,22,60,0,60
2011,7,Resto de Europa,35,23,74,3,135,0,135
2011,7,Estados Unidos,21,48,17,2,88,0,88
2011,7,Resto de América,6,90,102,48,246,0,246
2011,7,Resto del Mundo,72,150,106,47,375,0,375
2011,7,TOTAL,3731,3298,4235,772,12036,0,12036
2011,8,España,2396,1433,2126,342,6297,0,6297
2011,8,Holanda,20,1,14,3,38,0,38
2011,8,Bélgica,5,8,9,5,27,0,27
2011,8,Alemania,47,64,82,27,220,0,220
2011,8,Francia,54,103,129,95,381,0,381
2011,8,Gran Bretaña,30,36,70,4,140,0,140
2011,8,Irlanda,2,3,3,0,8,0,8
2011,8,Italia,119,46,124,29,318,0,318
2011,8,Suecia,8,1,2,0,11,0,11
2011,8,Noruega,6,13,1,0,20,0,20
2011,8,Dinamarca,10,6,2,3,21,0,21
2011,8,Finlandia,9,0,7,0,16,0,16
2011,8,Suiza,6,3,1,2,12,0,12
2011,8,Austria,11,24,8,1,44,0,44
2011,8,Rusia,7,17,18,0,42,0,42
2011,8,Países del Este,3,8,15,20,46,0,46
2011,8,Resto de Europa,48,75,49,1,173,0,173
2011,8,Estados Unidos,15,19,20,0,54,0,54
2011,8,Resto de América,27,154,84,56,321,0,321
2011,8,Resto del Mundo,72,81,62,28,243,0,243
2011,8,TOTAL,2895,2095,2826,616,8432,0,8432
2011,9,España,3514,2938,3846,457,10755,0,10755
2011,9,Holanda,31,10,27,0,68,0,68
2011,9,Bélgica,21,7,21,12,61,0,61
2011,9,Alemania,56,70,157,30,313,0,313
2011,9,Francia,41,45,68,54,208,0,208
2011,9,Gran Bretaña,45,39,83,8,175,0,175
2011,9,Irlanda,4,4,11,3,22,0,22
2011,9,Italia,54,77,154,27,312,0,312
2011,9,Suecia,17,3,9,0,29,0,29
2011,9,Noruega,0,6,4,3,13,0,13
2011,9,Dinamarca,0,4,14,0,18,0,18
2011,9,Finlandia,4,0,11,0,15,0,15
2011,9,Suiza,4,3,7,3,17,0,17
2011,9,Austria,8,4,8,0,20,0,20
2011,9,Rusia,8,8,19,9,44,0,44
2011,9,Países del Este,10,2,39,65,116,0,116
2011,9,Resto de Europa,16,30,56,6,108,0,108
2011,9,Estados Unidos,16,30,23,2,71,0,71
2011,9,Resto de América,10,301,146,72,529,0,529
2011,9,Resto del Mundo,78,130,82,29,319,0,319
2011,9,TOTAL,3937,3711,4785,780,13213,0,13213
2011,10,España,3720,2756,3567,465,10508,0,10508
2011,10,Holanda,16,18,33,2,69,0,69
2011,10,Bélgica,9,16,39,0,64,0,64
2011,10,Alemania,96,137,210,32,475,0,475
2011,10,Francia,21,175,117,60,373,0,373
2011,10,Gran Bretaña,22,75,107,3,207,0,207
2011,10,Irlanda,4,23,11,0,38,0,38
2011,10,Italia,11,58,111,56,236,0,236
2011,10,Suecia,5,7,37,0,49,0,49
2011,10,Noruega,5,13,52,2,72,0,72
2011,10,Dinamarca,2,11,12,3,28,0,28
2011,10,Finlandia,4,0,46,5,55,0,55
2011,10,Suiza,20,24,35,15,94,0,94
2011,10,Austria,4,12,11,6,33,0,33
2011,10,Rusia,3,20,19,9,51,0,51
2011,10,Países del Este,4,8,43,77,132,0,132
2011,10,Resto de Europa,21,54,107,11,193,0,193
2011,10,Estados Unidos,19,22,28,0,69,0,69
2011,10,Resto de América,27,94,157,68,346,0,346
2011,10,Resto del Mundo,60,130,118,32,340,0,340
2011,10,TOTAL,4073,3653,4860,846,13432,0,13432
2011,11,España,4059,3176,4200,436,11871,0,11871
2011,11,Holanda,17,54,49,6,126,0,126
2011,11,Bélgica,23,34,27,11,95,0,95
2011,11,Alemania,71,113,222,47,453,0,453
2011,11,Francia,43,63,106,74,286,0,286
2011,11,Gran Bretaña,35,128,136,8,307,0,307
2011,11,Irlanda,10,9,20,3,42,0,42
2011,11,Italia,22,87,155,50,314,0,314
2011,11,Suecia,6,4,56,2,68,0,68
2011,11,Noruega,3,14,37,0,54,0,54
2011,11,Dinamarca,0,13,27,3,43,0,43
2011,11,Finlandia,0,10,45,6,61,0,61
2011,11,Suiza,4,17,34,8,63,0,63
2011,11,Austria,2,25,13,2,42,0,42
2011,11,Rusia,2,11,86,8,107,0,107
2011,11,Países del Este,0,27,98,68,193,0,193
2011,11,Resto de Europa,18,49,126,8,201,0,201
2011,11,Estados Unidos,18,50,30,3,101,0,101
2011,11,Resto de América,8,150,145,59,362,0,362
2011,11,Resto del Mundo,24,134,204,36,398,0,398
2011,11,TOTAL,4365,4168,5816,838,15187,0,15187
2011,12,España,2271,2384,3448,438,8541,0,8541
2011,12,Holanda,45,25,53,11,134,0,134
2011,12,Bélgica,23,26,55,18,122,0,122
2011,12,Alemania,208,140,272,50,670,0,670
2011,12,Francia,60,79,121,66,326,0,326
2011,12,Gran Bretaña,107,133,120,35,395,0,395
2011,12,Irlanda,33,16,25,2,76,0,76
2011,12,Italia,39,80,175,38,332,0,332
2011,12,Suecia,16,21,36,3,76,0,76
2011,12,Noruega,16,30,44,2,92,0,92
2011,12,Dinamarca,8,23,43,2,76,0,76
2011,12,Finlandia,4,9,50,5,68,0,68
2011,12,Suiza,12,26,22,2,62,0,62
2011,12,Austria,21,11,18,3,53,0,53
2011,12,Rusia,12,18,80,3,113,0,113
2011,12,Países del Este,25,17,46,83,171,0,171
2011,12,Resto de Europa,27,54,88,8,177,0,177
2011,12,Estados Unidos,8,34,40,5,87,0,87
2011,12,Resto de América,19,226,117,51,413,0,413
2011,12,Resto del Mundo,105,148,172,27,452,0,452
2011,12,TOTAL,3059,3500,5025,852,12436,0,12436
2011,13,España,40506,34752,40492,5349,121099,0,121099
2011,13,Holanda,207,156,403,92,858,0,858
2011,13,Bélgica,226,192,259,103,780,0,780
2011,13,Alemania,999,1221,2032,495,4747,0,4747
2011,13,Francia,513,1074,1199,754,3540,0,3540
2011,13,Gran Bretaña,616,1165,1408,155,3344,0,3344
2011,13,Irlanda,94,143,180,39,456,0,456
2011,13,Italia,550,1060,1608,438,3656,0,3656
2011,13,Suecia,92,89,343,23,547,0,547
2011,13,Noruega,64,162,258,25,509,0,509
2011,13,Dinamarca,97,127,243,53,520,0,520
2011,13,Finlandia,66,89,430,33,618,0,618
2011,13,Suiza,91,193,237,57,578,0,578
2011,13,Austria,91,128,133,38,390,0,390
2011,13,Rusia,55,151,551,53,810,0,810
2011,13,Países del Este,91,142,666,521,1420,0,1420
2011,13,Resto de Europa,283,567,1088,92,2030,0,2030
2011,13,Estados Unidos,240,376,299,26,941,0,941
2011,13,Resto de América,172,1502,1453,565,3692,0,3692
2011,13,Resto del Mundo,701,1771,1403,393,4268,0,4268
2011,13,TOTAL,45754,45060,54685,9304,154803,0,154803
2012,1,España,3870,3015,3511,363,10759,0,10759
2012,1,Holanda,28,9,56,14,107,0,107
2012,1,Bélgica,11,53,44,9,117,0,117
2012,1,Alemania,105,242,239,62,648,0,648
2012,1,Francia,38,83,107,59,287,0,287
2012,1,Gran Bretaña,126,214,179,24,543,0,543
2012,1,Irlanda,17,55,26,3,101,0,101
2012,1,Italia,56,118,183,47,404,0,404
2012,1,Suecia,11,12,65,9,97,0,97
2012,1,Noruega,13,28,34,2,77,0,77
2012,1,Dinamarca,7,23,27,20,77,0,77
2012,1,Finlandia,6,23,61,3,93,0,93
2012,1,Suiza,35,46,53,11,145,0,145
2012,1,Austria,48,18,10,6,82,0,82
2012,1,Rusia,61,21,88,3,173,0,173
2012,1,Países del Este,31,12,72,57,172,0,172
2012,1,Resto de Europa,16,35,118,0,169,0,169
2012,1,Estados Unidos,18,25,26,8,77,0,77
2012,1,Resto de América,13,69,147,65,294,0,294
2012,1,Resto del Mundo,110,256,150,12,528,0,528
2012,1,TOTAL,4620,4357,5196,777,14950,0,14950
2012,2,España,4145,4616,4021,417,13199,0,13199
2012,2,Holanda,39,32,36,2,109,0,109
2012,2,Bélgica,32,40,47,17,136,0,136
2012,2,Alemania,172,249,265,86,772,0,772
2012,2,Francia,80,146,153,45,424,0,424
2012,2,Gran Bretaña,110,437,306,30,883,0,883
2012,2,Irlanda,15,12,28,5,60,0,60
2012,2,Italia,48,150,190,33,421,0,421
2012,2,Suecia,11,95,95,2,203,0,203
2012,2,Noruega,13,53,50,2,118,0,118
2012,2,Dinamarca,22,24,20,2,68,0,68
2012,2,Finlandia,10,109,108,2,229,0,229
2012,2,Suiza,31,28,31,9,99,0,99
2012,2,Austria,12,16,23,15,66,0,66
2012,2,Rusia,31,32,57,8,128,0,128
2012,2,Países del Este,13,42,49,56,160,0,160
2012,2,Resto de Europa,37,98,87,3,225,0,225
2012,2,Estados Unidos,28,44,28,3,103,0,103
2012,2,Resto de América,35,144,112,78,369,0,369
2012,2,Resto del Mundo,53,131,107,14,305,0,305
2012,2,TOTAL,4937,6498,5813,829,18077,0,18077
2012,3,España,4542,4024,2265,347,11178,0,11178
2012,3,Holanda,28,24,18,11,81,0,81
2012,3,Bélgica,24,23,15,2,64,0,64
2012,3,Alemania,161,232,147,80,620,0,620
2012,3,Francia,40,76,95,63,274,0,274
2012,3,Gran Bretaña,92,196,42,30,360,0,360
2012,3,Irlanda,7,12,4,3,26,0,26
2012,3,Italia,39,127,90,44,300,0,300
2012,3,Suecia,9,74,30,2,115,0,115
2012,3,Noruega,9,47,4,0,60,0,60
2012,3,Dinamarca,1,67,5,0,73,0,73
2012,3,Finlandia,4,49,15,2,70,0,70
2012,3,Suiza,27,23,16,9,75,0,75
2012,3,Austria,4,8,3,2,17,0,17
2012,3,Rusia,2,16,32,5,55,0,55
2012,3,Países del Este,7,47,36,47,137,0,137
2012,3,Resto de Europa,27,66,84,3,180,0,180
2012,3,Estados Unidos,28,42,28,2,100,0,100
2012,3,Resto de América,46,149,73,88,356,0,356
2012,3,Resto del Mundo,58,160,46,30,294,0,294
2012,3,TOTAL,5155,5462,3048,770,14435,0,14435
2012,4,España,4029,3165,3059,383,10636,0,10636
2012,4,Holanda,26,26,29,0,81,0,81
2012,4,Bélgica,19,15,28,6,68,0,68
2012,4,Alemania,127,90,112,36,365,0,365
2012,4,Francia,65,77,117,77,336,0,336
2012,4,Gran Bretaña,112,137,94,8,351,0,351
2012,4,Irlanda,5,12,12,0,29,0,29
2012,4,Italia,34,107,106,23,270,0,270
2012,4,Suecia,14,13,12,0,39,0,39
2012,4,Noruega,8,19,17,0,44,0,44
2012,4,Dinamarca,4,3,8,0,15,0,15
2012,4,Finlandia,9,17,23,0,49,0,49
2012,4,Suiza,16,16,16,5,53,0,53
2012,4,Austria,2,10,13,2,27,0,27
2012,4,Rusia,58,111,85,0,254,0,254
2012,4,Países del Este,40,61,70,27,198,0,198
2012,4,Resto de Europa,21,76,105,0,202,0,202
2012,4,Estados Unidos,37,69,40,0,146,0,146
2012,4,Resto de América,24,173,156,63,416,0,416
2012,4,Resto del Mundo,47,91,106,26,270,0,270
2012,4,TOTAL,4697,4288,4208,656,13849,0,13849
2012,5,España,4196,3320,3395,414,11325,0,11325
2012,5,Holanda,18,8,37,3,66,0,66
2012,5,Bélgica,9,4,18,8,39,0,39
2012,5,Alemania,78,51,114,23,266,0,266
2012,5,Francia,71,84,72,32,259,0,259
2012,5,Gran Bretaña,138,41,68,2,249,0,249
2012,5,Irlanda,2,8,8,3,21,0,21
2012,5,Italia,36,151,87,38,312,0,312
2012,5,Suecia,7,4,10,0,21,0,21
2012,5,Noruega,6,0,4,0,10,0,10
2012,5,Dinamarca,2,3,14,0,19,0,19
2012,5,Finlandia,0,1,29,0,30,0,30
2012,5,Suiza,8,6,14,3,31,0,31
2012,5,Austria,0,4,8,8,20,0,20
2012,5,Rusia,7,12,18,12,49,0,49
2012,5,Países del Este,35,14,25,17,91,0,91
2012,5,Resto de Europa,19,87,61,20,187,0,187
2012,5,Estados Unidos,38,30,21,3,92,0,92
2012,5,Resto de América,27,142,129,41,339,0,339
2012,5,Resto del Mundo,52,86,85,32,255,0,255
2012,5,TOTAL,4749,4056,4217,659,13681,0,13681
2012,6,España,5517,3899,1925,374,11715,0,11715
2012,6,Holanda,11,12,4,0,27,0,27
2012,6,Bélgica,29,20,6,9,64,0,64
2012,6,Alemania,90,68,45,11,214,0,214
2012,6,Francia,28,50,40,30,148,0,148
2012,6,Gran Bretaña,80,87,11,9,187,0,187
2012,6,Irlanda,6,12,0,5,23,0,23
2012,6,Italia,73,52,65,27,217,0,217
2012,6,Suecia,0,2,2,0,4,0,4
2012,6,Noruega,0,5,3,0,8,0,8
2012,6,Dinamarca,18,6,1,0,25,0,25
2012,6,Finlandia,0,28,2,2,32,0,32
2012,6,Suiza,21,17,5,0,43,0,43
2012,6,Austria,0,3,1,6,10,0,10
2012,6,Rusia,2,15,17,3,37,0,37
2012,6,Países del Este,6,14,8,29,57,0,57
2012,6,Resto de Europa,13,51,29,3,96,0,96
2012,6,Estados Unidos,27,44,9,5,85,0,85
2012,6,Resto de América,9,171,52,88,320,0,320
2012,6,Resto del Mundo,159,92,40,41,332,0,332
2012,6,TOTAL,6089,4648,2265,642,13644,0,13644
2012,7,España,4383,2628,1703,276,8990,0,8990
2012,7,Holanda,25,14,5,3,47,0,47
2012,7,Bélgica,13,8,6,9,36,0,36
2012,7,Alemania,83,254,30,27,394,0,394
2012,7,Francia,94,62,64,59,279,0,279
2012,7,Gran Bretaña,157,376,20,3,556,0,556
2012,7,Irlanda,8,7,2,1,18,0,18
2012,7,Italia,66,57,71,23,217,0,217
2012,7,Suecia,17,3,2,0,22,0,22
2012,7,Noruega,12,5,6,0,23,0,23
2012,7,Dinamarca,3,3,2,0,8,0,8
2012,7,Finlandia,1,23,3,0,27,0,27
2012,7,Suiza,17,6,3,0,26,0,26
2012,7,Austria,7,4,2,1,14,0,14
2012,7,Rusia,20,42,31,6,99,0,99
2012,7,Países del Este,76,56,15,4,151,0,151
2012,7,Resto de Europa,36,75,50,5,166,0,166
2012,7,Estados Unidos,84,41,7,1,133,0,133
2012,7,Resto de América,41,159,66,30,296,0,296
2012,7,Resto del Mundo,103,96,36,13,248,0,248
2012,7,TOTAL,5246,3919,2124,461,11750,0,11750
2012,8,España,3248,2058,1049,285,6640,0,6640
2012,8,Holanda,66,23,7,2,98,0,98
2012,8,Bélgica,27,23,0,3,53,0,53
2012,8,Alemania,117,87,33,17,254,0,254
2012,8,Francia,190,79,58,51,378,0,378
2012,8,Gran Bretaña,177,260,30,2,469,0,469
2012,8,Irlanda,17,7,0,6,30,0,30
2012,8,Italia,166,128,297,66,657,0,657
2012,8,Suecia,6,6,1,2,15,0,15
2012,8,Noruega,2,18,4,3,27,0,27
2012,8,Dinamarca,14,8,0,0,22,0,22
2012,8,Finlandia,9,27,0,0,36,0,36
2012,8,Suiza,6,20,4,11,41,0,41
2012,8,Austria,2,0,6,8,16,0,16
2012,8,Rusia,20,30,14,3,67,0,67
2012,8,Países del Este,204,42,12,27,285,0,285
2012,8,Resto de Europa,13,39,40,12,104,0,104
2012,8,Estados Unidos,27,4,4,0,35,0,35
2012,8,Resto de América,63,120,82,50,315,0,315
2012,8,Resto del Mundo,136,68,64,20,288,0,288
2012,8,TOTAL,4510,3047,1705,568,9830,0,9830
2012,9,España,4279,2761,1780,337,9157,0,9157
2012,9,Holanda,37,11,27,0,75,0,75
2012,9,Bélgica,42,13,12,0,67,0,67
2012,9,Alemania,316,164,85,24,589,0,589
2012,9,Francia,65,60,73,30,228,0,228
2012,9,Gran Bretaña,114,68,17,3,202,0,202
2012,9,Irlanda,12,17,9,3,41,0,41
2012,9,Italia,65,93,49,38,245,0,245
2012,9,Suecia,13,4,1,0,18,0,18
2012,9,Noruega,11,8,2,0,21,0,21
2012,9,Dinamarca,6,0,1,0,7,0,7
2012,9,Finlandia,11,15,6,3,35,0,35
2012,9,Suiza,51,17,4,3,75,0,75
2012,9,Austria,10,8,8,2,28,0,28
2012,9,Rusia,31,28,19,3,81,0,81
2012,9,Países del Este,90,16,23,24,153,0,153
2012,9,Resto de Europa,24,79,46,3,152,0,152
2012,9,Estados Unidos,29,34,4,20,87,0,87
2012,9,Resto de América,46,195,136,47,424,0,424
2012,9,Resto del Mundo,142,81,24,12,259,0,259
2012,9,TOTAL,5394,3672,2326,552,11944,0,11944
2012,10,España,4478,4072,2027,441,11018,0,11018
2012,10,Holanda,38,38,20,2,98,0,98
2012,10,Bélgica,24,16,6,6,52,0,52
2012,10,Alemania,166,179,119,27,491,0,491
2012,10,Francia,57,79,76,26,238,0,238
2012,10,Gran Bretaña,281,220,20,3,524,0,524
2012,10,Irlanda,4,70,1,2,77,0,77
2012,10,Italia,53,102,67,23,245,0,245
2012,10,Suecia,27,26,13,2,68,0,68
2012,10,Noruega,12,25,3,0,40,0,40
2012,10,Dinamarca,7,19,6,0,32,0,32
2012,10,Finlandia,3,70,5,0,78,0,78
2012,10,Suiza,31,42,14,11,98,0,98
2012,10,Austria,8,8,14,0,30,0,30
2012,10,Rusia,32,54,52,6,144,0,144
2012,10,Países del Este,78,223,19,8,328,0,328
2012,10,Resto de Europa,25,75,53,35,188,0,188
2012,10,Estados Unidos,75,47,8,0,130,0,130
2012,10,Resto de América,46,186,94,30,356,0,356
2012,10,Resto del Mundo,91,80,56,72,299,0,299
2012,10,TOTAL,5536,5631,2673,694,14534,0,14534
2012,11,España,4622,4062,2122,442,11248,0,11248
2012,11,Holanda,41,52,26,11,130,0,130
2012,11,Bélgica,41,21,20,8,90,0,90
2012,11,Alemania,271,206,132,47,656,0,656
2012,11,Francia,91,131,97,80,399,0,399
2012,11,Gran Bretaña,242,972,48,8,1270,0,1270
2012,11,Irlanda,60,23,15,2,100,0,100
2012,11,Italia,126,156,72,60,414,0,414
2012,11,Suecia,102,68,25,5,200,0,200
2012,11,Noruega,65,59,19,5,148,0,148
2012,11,Dinamarca,28,77,4,2,111,0,111
2012,11,Finlandia,36,62,19,0,117,0,117
2012,11,Suiza,40,44,18,3,105,0,105
2012,11,Austria,21,15,6,3,45,0,45
2012,11,Rusia,77,48,43,5,173,0,173
2012,11,Países del Este,11,32,28,3,74,0,74
2012,11,Resto de Europa,62,119,45,32,258,0,258
2012,11,Estados Unidos,48,47,11,12,118,0,118
2012,11,Resto de América,50,186,46,32,314,0,314
2012,11,Resto del Mundo,206,191,85,21,503,0,503
2012,11,TOTAL,6240,6571,2881,781,16473,0,16473
2012,12,España,3965,3243,1982,394,9584,0,9584
2012,12,Holanda,49,29,30,6,114,0,114
2012,12,Bélgica,52,32,17,3,104,0,104
2012,12,Alemania,528,274,145,74,1021,0,1021
2012,12,Francia,108,120,93,59,380,0,380
2012,12,Gran Bretaña,279,207,76,21,583,0,583
2012,12,Irlanda,60,18,13,8,99,0,99
2012,12,Italia,76,143,88,21,328,0,328
2012,12,Suecia,173,81,53,5,312,0,312
2012,12,Noruega,133,58,29,2,222,0,222
2012,12,Dinamarca,48,47,20,6,121,0,121
2012,12,Finlandia,72,63,36,5,176,0,176
2012,12,Suiza,42,55,17,9,123,0,123
2012,12,Austria,44,19,11,3,77,0,77
2012,12,Rusia,30,56,38,6,130,0,130
2012,12,Países del Este,24,53,47,2,126,0,126
2012,12,Resto de Europa,52,135,55,30,272,0,272
2012,12,Estados Unidos,96,69,15,5,185,0,185
2012,12,Resto de América,13,180,67,39,299,0,299
2012,12,Resto del Mundo,122,188,74,32,416,0,416
2012,12,TOTAL,5966,5070,2906,730,14672,0,14672
2012,13,España,51274,40863,28839,4473,125449,0,125449
2012,13,Holanda,406,278,295,54,1033,0,1033
2012,13,Bélgica,323,268,219,80,890,0,890
2012,13,Alemania,2214,2096,1466,514,6290,0,6290
2012,13,Francia,927,1047,1045,611,3630,0,3630
2012,13,Gran Bretaña,1908,3215,911,143,6177,0,6177
2012,13,Irlanda,213,253,118,41,625,0,625
2012,13,Italia,838,1384,1365,443,4030,0,4030
2012,13,Suecia,390,388,309,27,1114,0,1114
2012,13,Noruega,284,325,175,14,798,0,798
2012,13,Dinamarca,160,280,108,30,578,0,578
2012,13,Finlandia,161,487,307,17,972,0,972
2012,13,Suiza,325,320,195,74,914,0,914
2012,13,Austria,158,113,105,56,432,0,432
2012,13,Rusia,371,465,494,60,1390,0,1390
2012,13,Países del Este,615,612,404,301,1932,0,1932
2012,13,Resto de Europa,345,935,773,146,2199,0,2199
2012,13,Estados Unidos,535,496,201,59,1291,0,1291
2012,13,Resto de América,413,1874,1160,651,4098,0,4098
2012,13,Resto del Mundo,1279,1520,873,325,3997,0,3997
2012,13,TOTAL,63139,57219,39362,8119,167839,0,167839
2013,1,España,4449,4172,2319,528,11468,0,11468
2013,1,Holanda,39,41,42,12,134,0,134
2013,1,Bélgica,64,54,23,15,156,0,156
2013,1,Alemania,188,366,127,81,762,0,762
2013,1,Francia,93,109,101,83,386,0,386
2013,1,Gran Bretaña,400,224,93,33,750,0,750
2013,1,Irlanda,25,14,15,2,56,0,56
2013,1,Italia,66,147,97,66,376,0,376
2013,1,Suecia,177,29,39,6,251,0,251
2013,1,Noruega,127,55,31,9,222,0,222
2013,1,Dinamarca,69,37,24,6,136,0,136
2013,1,Finlandia,52,74,20,8,154,0,154
2013,1,Suiza,46,47,19,6,118,0,118
2013,1,Austria,23,36,11,9,79,0,79
2013,1,Rusia,156,99,68,18,341,0,341
2013,1,Países del Este,180,45,52,15,292,0,292
2013,1,Resto de Europa,26,91,104,66,287,0,287
2013,1,Estados Unidos,30,19,19,6,74,0,74
2013,1,Resto de América,28,138,80,56,302,0,302
2013,1,Resto del Mundo,91,114,58,35,298,0,298
2013,1,TOTAL,6329,5911,3342,1060,16642,0,16642
2013,2,España,4353,4576,2502,724,12155,0,12155
2013,2,Holanda,44,26,20,3,93,0,93
2013,2,Bélgica,41,47,29,11,128,0,128
2013,2,Alemania,194,167,150,91,602,0,602
2013,2,Francia,146,162,118,94,520,0,520
2013,2,Gran Bretaña,325,214,68,36,643,0,643
2013,2,Irlanda,71,36,12,2,121,0,121
2013,2,Italia,77,166,85,72,400,0,400
2013,2,Suecia,151,69,26,6,252,0,252
2013,2,Noruega,108,95,23,5,231,0,231
2013,2,Dinamarca,61,42,16,9,128,0,128
2013,2,Finlandia,37,93,12,0,142,0,142
2013,2,Suiza,31,36,14,18,99,0,99
2013,2,Austria,78,20,6,6,110,0,110
2013,2,Rusia,33,63,34,5,135,0,135
2013,2,Países del Este,267,91,26,14,398,0,398
2013,2,Resto de Europa,22,95,52,26,195,0,195
2013,2,Estados Unidos,53,41,13,11,118,0,118
2013,2,Resto de América,32,128,78,48,286,0,286
2013,2,Resto del Mundo,79,129,70,17,295,0,295
2013,2,TOTAL,6203,6296,3354,1198,17051,0,17051
2013,3,España,5026,3713,1762,639,11140,0,11140
2013,3,Holanda,87,28,21,6,142,0,142
2013,3,Bélgica,58,35,12,8,113,0,113
2013,3,Alemania,206,242,133,89,670,0,670
2013,3,Francia,285,199,147,81,712,0,712
2013,3,Gran Bretaña,277,274,44,20,615,0,615
2013,3,Irlanda,23,203,11,6,243,0,243
2013,3,Italia,62,207,76,56,401,0,401
2013,3,Suecia,149,80,5,2,236,0,236
2013,3,Noruega,109,45,28,3,185,0,185
2013,3,Dinamarca,48,63,4,2,117,0,117
2013,3,Finlandia,40,99,11,3,153,0,153
2013,3,Suiza,19,30,6,6,61,0,61
2013,3,Austria,25,64,5,3,97,0,97
2013,3,Rusia,17,38,46,17,118,0,118
2013,3,Países del Este,79,60,26,3,168,0,168
2013,3,Resto de Europa,11,118,82,74,285,0,285
2013,3,Estados Unidos,38,36,19,20,113,0,113
2013,3,Resto de América,39,142,53,41,275,0,275
2013,3,Resto del Mundo,108,127,58,44,337,0,337
2013,3,TOTAL,6706,5803,2549,1123,16181,0,16181
2013,4,España,4397,3391,1765,515,10068,0,10068
2013,4,Holanda,31,36,12,8,87,0,87
2013,4,Bélgica,42,17,2,12,73,0,73
2013,4,Alemania,137,144,60,44,385,0,385
2013,4,Francia,104,120,141,85,450,0,450
2013,4,Gran Bretaña,158,141,24,17,340,0,340
2013,4,Irlanda,18,20,9,0,47,0,47
2013,4,Italia,69,101,52,65,287,0,287
2013,4,Suecia,90,32,4,0,126,0,126
2013,4,Noruega,23,28,3,8,62,0,62
2013,4,Dinamarca,24,11,1,2,38,0,38
2013,4,Finlandia,27,29,11,3,70,0,70
2013,4,Suiza,41,24,15,5,85,0,85
2013,4,Austria,22,6,3,5,36,0,36
2013,4,Rusia,54,44,33,12,143,0,143
2013,4,Países del Este,171,44,16,14,245,0,245
2013,4,Resto de Europa,21,100,44,39,204,0,204
2013,4,Estados Unidos,39,34,12,8,93,0,93
2013,4,Resto de América,29,123,50,57,259,0,259
2013,4,Resto del Mundo,76,126,44,39,285,0,285
2013,4,TOTAL,5573,4571,2301,938,13383,0,13383
2013,5,España,4420,3386,1788,501,10095,0,10095
2013,5,Holanda,22,25,10,0,57,0,57
2013,5,Bélgica,30,23,8,0,61,0,61
2013,5,Alemania,92,110,50,24,276,0,276
2013,5,Francia,90,133,100,62,385,0,385
2013,5,Gran Bretaña,111,99,42,9,261,0,261
2013,5,Irlanda,5,3,6,2,16,0,16
2013,5,Italia,29,86,48,45,208,0,208
2013,5,Suecia,16,3,2,3,24,0,24
2013,5,Noruega,7,5,4,0,16,0,16
2013,5,Dinamarca,3,7,0,2,12,0,12
2013,5,Finlandia,2,4,5,0,11,0,11
2013,5,Suiza,23,13,9,5,50,0,50
2013,5,Austria,9,2,5,6,22,0,22
2013,5,Rusia,23,21,41,15,100,0,100
2013,5,Países del Este,116,27,20,8,171,0,171
2013,5,Resto de Europa,39,56,44,18,157,0,157
2013,5,Estados Unidos,56,22,5,0,83,0,83
2013,5,Resto de América,29,145,46,47,267,0,267
2013,5,Resto del Mundo,102,94,50,20,266,0,266
2013,5,TOTAL,5224,4264,2283,767,12538,0,12538
2013,6,España,4323,3462,1801,604,10190,0,10190
2013,6,Holanda,21,19,12,3,55,0,55
2013,6,Bélgica,26,21,5,2,54,0,54
2013,6,Alemania,104,122,49,11,286,0,286
2013,6,Francia,38,155,48,59,300,0,300
2013,6,Gran Bretaña,144,491,19,11,665,0,665
2013,6,Irlanda,11,16,3,3,33,0,33
2013,6,Italia,35,77,67,32,211,0,211
2013,6,Suecia,12,5,2,0,19,0,19
2013,6,Noruega,1,6,3,0,10,0,10
2013,6,Dinamarca,5,5,0,0,10,0,10
2013,6,Finlandia,5,17,0,0,22,0,22
2013,6,Suiza,10,10,4,5,29,0,29
2013,6,Austria,2,3,5,0,10,0,10
2013,6,Rusia,34,33,35,17,119,0,119
2013,6,Países del Este,166,24,9,5,204,0,204
2013,6,Resto de Europa,14,105,39,18,176,0,176
2013,6,Estados Unidos,35,25,4,2,66,0,66
2013,6,Resto de América,21,113,67,29,230,0,230
2013,6,Resto del Mundo,99,122,35,38,294,0,294
2013,6,TOTAL,5106,4831,2207,839,12983,0,12983
2013,7,España,4217,3382,1592,831,10022,0,10022
2013,7,Holanda,16,26,10,11,63,0,63
2013,7,Bélgica,34,20,6,6,66,0,66
2013,7,Alemania,135,52,48,40,275,0,275
2013,7,Francia,125,111,104,103,443,0,443
2013,7,Gran Bretaña,145,86,23,32,286,0,286
2013,7,Irlanda,9,14,6,0,29,0,29
2013,7,Italia,132,121,41,36,330,0,330
2013,7,Suecia,22,31,8,0,61,0,61
2013,7,Noruega,12,13,2,0,27,0,27
2013,7,Dinamarca,5,152,2,0,159,0,159
2013,7,Finlandia,18,1,2,0,21,0,21
2013,7,Suiza,21,26,3,17,67,0,67
2013,7,Austria,16,11,10,0,37,0,37
2013,7,Rusia,81,33,53,25,192,0,192
2013,7,Países del Este,89,38,24,4,155,0,155
2013,7,Resto de Europa,56,83,30,59,228,0,228
2013,7,Estados Unidos,124,28,3,2,157,0,157
2013,7,Resto de América,74,146,65,99,384,0,384
2013,7,Resto del Mundo,176,158,45,27,406,0,406
2013,7,TOTAL,5507,4532,2077,1292,13408,0,13408
2013,8,España,2914,2539,1185,886,7524,0,7524
2013,8,Holanda,22,23,9,2,56,0,56
2013,8,Bélgica,34,25,29,14,102,0,102
2013,8,Alemania,126,84,35,33,278,0,278
2013,8,Francia,127,200,119,115,561,0,561
2013,8,Gran Bretaña,421,1026,21,9,1477,0,1477
2013,8,Irlanda,18,10,3,0,31,0,31
2013,8,Italia,122,308,303,71,804,0,804
2013,8,Suecia,0,6,3,0,9,0,9
2013,8,Noruega,15,1,1,2,19,0,19
2013,8,Dinamarca,8,14,0,5,27,0,27
2013,8,Finlandia,0,7,0,0,7,0,7
2013,8,Suiza,14,8,3,0,25,0,25
2013,8,Austria,13,6,2,0,21,0,21
2013,8,Rusia,45,93,20,9,167,0,167
2013,8,Países del Este,32,38,8,16,94,0,94
2013,8,Resto de Europa,19,58,39,22,138,0,138
2013,8,Estados Unidos,49,31,3,2,85,0,85
2013,8,Resto de América,41,108,56,39,244,0,244
2013,8,Resto del Mundo,94,136,32,24,286,0,286
2013,8,TOTAL,4114,4721,1871,1249,11955,0,11955
2013,9,España,3594,3175,1865,610,9244,0,9244
2013,9,Holanda,17,20,11,4,52,0,52
2013,9,Bélgica,42,16,19,11,88,0,88
2013,9,Alemania,154,72,73,44,343,0,343
2013,9,Francia,59,80,69,98,306,0,306
2013,9,Gran Bretaña,251,86,19,14,370,0,370
2013,9,Irlanda,7,10,0,2,19,0,19
2013,9,Italia,83,121,139,68,411,0,411
2013,9,Suecia,4,7,10,0,21,0,21
2013,9,Noruega,3,8,10,0,21,0,21
2013,9,Dinamarca,9,4,4,2,19,0,19
2013,9,Finlandia,2,10,1,14,27,0,27
2013,9,Suiza,18,10,10,11,49,0,49
2013,9,Austria,16,3,3,0,22,0,22
2013,9,Rusia,32,243,18,21,314,0,314
2013,9,Países del Este,21,11,14,12,58,0,58
2013,9,Resto de Europa,34,104,68,46,252,0,252
2013,9,Estados Unidos,61,26,9,2,98,0,98
2013,9,Resto de América,44,140,78,74,336,0,336
2013,9,Resto del Mundo,97,111,31,40,279,0,279
2013,9,TOTAL,4548,4257,2451,1073,12329,0,12329
2013,10,España,3739,3696,1968,663,10066,0,10066
2013,10,Holanda,23,25,12,5,65,0,65
2013,10,Bélgica,90,23,6,21,140,0,140
2013,10,Alemania,178,176,70,59,483,0,483
2013,10,Francia,106,163,74,87,430,0,430
2013,10,Gran Bretaña,289,390,20,14,713,0,713
2013,10,Irlanda,19,134,13,0,166,0,166
2013,10,Italia,41,152,89,59,341,0,341
2013,10,Suecia,129,14,20,6,169,0,169
2013,10,Noruega,68,62,6,0,136,0,136
2013,10,Dinamarca,32,18,0,1,51,0,51
2013,10,Finlandia,117,27,4,2,150,0,150
2013,10,Suiza,75,31,25,5,136,0,136
2013,10,Austria,24,35,6,0,65,0,65
2013,10,Rusia,60,73,38,7,178,0,178
2013,10,Países del Este,23,51,20,36,130,0,130
2013,10,Resto de Europa,31,111,68,30,240,0,240
2013,10,Estados Unidos,113,117,9,5,244,0,244
2013,10,Resto de América,25,114,95,62,296,0,296
2013,10,Resto del Mundo,76,149,40,15,280,0,280
2013,10,TOTAL,5258,5561,2583,1077,14479,0,14479
2013,11,España,5233,5600,2581,911,14325,0,14325
2013,11,Holanda,43,51,33,27,154,0,154
2013,11,Bélgica,36,28,32,25,121,0,121
2013,11,Alemania,348,257,141,129,875,0,875
2013,11,Francia,150,158,123,144,575,0,575
2013,11,Gran Bretaña,480,498,60,35,1073,0,1073
2013,11,Irlanda,30,26,6,5,67,0,67
2013,11,Italia,91,192,117,90,490,0,490
2013,11,Suecia,409,117,31,10,567,0,567
2013,11,Noruega,280,103,24,4,411,0,411
2013,11,Dinamarca,73,82,4,4,163,0,163
2013,11,Finlandia,99,96,43,19,257,0,257
2013,11,Suiza,86,47,21,20,174,0,174
2013,11,Austria,14,35,11,12,72,0,72
2013,11,Rusia,71,72,53,27,223,0,223
2013,11,Países del Este,33,40,31,62,166,0,166
2013,11,Resto de Europa,53,158,139,48,398,0,398
2013,11,Estados Unidos,77,49,13,6,145,0,145
2013,11,Resto de América,61,192,117,73,443,0,443
2013,11,Resto del Mundo,95,220,42,28,385,0,385
2013,11,TOTAL,7762,8021,3622,1679,21084,0,21084
2013,12,España,4364,4518,2172,794,11848,0,11848
2013,12,Holanda,56,65,25,20,166,0,166
2013,12,Bélgica,57,47,16,12,132,0,132
2013,12,Alemania,475,337,203,178,1193,0,1193
2013,12,Francia,148,202,123,133,606,0,606
2013,12,Gran Bretaña,393,280,126,36,835,0,835
2013,12,Irlanda,31,37,24,2,94,0,94
2013,12,Italia,105,240,116,77,538,0,538
2013,12,Suecia,450,139,53,16,658,0,658
2013,12,Noruega,173,137,59,19,388,0,388
2013,12,Dinamarca,78,86,27,20,211,0,211
2013,12,Finlandia,130,175,50,14,369,0,369
2013,12,Suiza,66,53,26,12,157,0,157
2013,12,Austria,30,23,16,6,75,0,75
2013,12,Rusia,35,80,49,31,195,0,195
2013,12,Países del Este,36,35,54,38,163,0,163
2013,12,Resto de Europa,33,162,91,47,333,0,333
2013,12,Estados Unidos,44,56,13,7,120,0,120
2013,12,Resto de América,46,175,104,59,384,0,384
2013,12,Resto del Mundo,149,289,54,67,559,0,559
2013,12,TOTAL,6899,7136,3401,1588,19024,0,19024
2013,13,España,42489,47306,26751,10164,109368,20212,107933
2013,13,Holanda,384,377,240,109,1020,118,1006
2013,13,Bélgica,494,375,217,140,1122,120,1114
2013,13,Alemania,2098,2194,1216,869,5918,561,5867
2013,13,Francia,1308,1689,1381,1134,5093,743,4931
2013,13,Gran Bretaña,3105,3521,1094,265,7120,951,7077
2013,13,Irlanda,247,513,129,30,863,62,860
2013,13,Italia,745,1887,1320,777,4324,541,4256
2013,13,Suecia,1575,530,229,59,2313,80,2313
2013,13,Noruega,913,552,208,55,1691,37,1691
2013,13,Dinamarca,405,374,237,55,902,169,902
2013,13,Finlandia,506,637,175,65,1340,43,1340
2013,13,Suiza,419,330,184,95,976,96,954
2013,13,Austria,254,248,82,62,599,47,599
2013,13,Rusia,526,941,466,250,1956,311,1914
2013,13,Países del Este,958,697,329,251,1894,359,1885
2013,13,Resto de Europa,289,1123,919,485,2566,404,2489
2013,13,Estados Unidos,560,590,168,74,1177,223,1173
2013,13,Resto de América,374,1500,1016,688,3220,614,3092
2013,13,Resto del Mundo,967,1770,759,409,3335,700,3270
2013,13,TOTAL,58616,67154,37120,16036,156797,26391,154666
2014,1,España,3885,4415,1727,709,10736,0,10736
2014,1,Holanda,46,63,35,17,161,0,161
2014,1,Bélgica,46,67,23,31,167,0,167
2014,1,Alemania,342,370,168,141,1021,0,1021
2014,1,Francia,111,218,123,119,571,0,571
2014,1,Gran Bretaña,430,366,97,78,971,0,971
2014,1,Irlanda,36,61,25,22,144,0,144
2014,1,Italia,108,271,139,119,637,0,637
2014,1,Suecia,491,157,54,22,724,0,724
2014,1,Noruega,176,173,47,1,397,0,397
2014,1,Dinamarca,70,98,19,14,201,0,201
2014,1,Finlandia,120,312,56,17,505,0,505
2014,1,Suiza,66,66,15,20,167,0,167
2014,1,Austria,25,16,26,15,82,0,82
2014,1,Rusia,89,225,69,28,411,0,411
2014,1,Países del Este,64,52,43,53,212,0,212
2014,1,Resto de Europa,36,187,114,51,388,0,388
2014,1,Estados Unidos,252,36,17,9,314,0,314
2014,1,Resto de América,50,199,93,38,380,0,380
2014,1,Resto del Mundo,158,236,43,38,475,0,475
2014,1,TOTAL,6601,7588,2933,1542,18664,0,18664
2014,2,España,3809,5709,2268,710,12496,0,12496
2014,2,Holanda,25,91,26,31,173,0,173
2014,2,Bélgica,51,70,35,19,175,0,175
2014,2,Alemania,293,405,193,121,1012,0,1012
2014,2,Francia,118,314,151,124,707,0,707
2014,2,Gran Bretaña,522,602,104,51,1279,0,1279
2014,2,Irlanda,25,58,50,3,136,0,136
2014,2,Italia,82,294,162,119,657,0,657
2014,2,Suecia,347,139,48,22,556,0,556
2014,2,Noruega,124,190,25,19,358,0,358
2014,2,Dinamarca,73,111,11,22,217,0,217
2014,2,Finlandia,66,127,29,5,227,0,227
2014,2,Suiza,73,107,26,25,231,0,231
2014,2,Austria,45,59,21,19,144,0,144
2014,2,Rusia,99,163,68,45,375,0,375
2014,2,Países del Este,64,78,49,45,236,0,236
2014,2,Resto de Europa,57,233,85,76,451,0,451
2014,2,Estados Unidos,38,71,8,17,134,0,134
2014,2,Resto de América,25,94,68,42,229,0,229
2014,2,Resto del Mundo,59,284,57,43,443,0,443
2014,2,TOTAL,5995,9199,3484,1558,20236,0,20236
2014,3,España,3948,6332,2572,689,13541,0,13541
2014,3,Holanda,39,32,18,28,117,0,117
2014,3,Bélgica,42,52,15,5,114,0,114
2014,3,Alemania,302,324,127,214,967,0,967
2014,3,Francia,154,244,122,125,645,0,645
2014,3,Gran Bretaña,417,338,82,85,922,0,922
2014,3,Irlanda,24,42,5,9,80,0,80
2014,3,Italia,51,265,146,83,545,0,545
2014,3,Suecia,352,79,11,14,456,0,456
2014,3,Noruega,123,148,17,4,292,0,292
2014,3,Dinamarca,62,81,4,6,153,0,153
2014,3,Finlandia,68,118,15,17,218,0,218
2014,3,Suiza,31,38,5,7,81,0,81
2014,3,Austria,20,71,18,2,111,0,111
2014,3,Rusia,34,67,61,63,225,0,225
2014,3,Países del Este,36,53,27,41,157,0,157
2014,3,Resto de Europa,23,142,100,69,334,0,334
2014,3,Estados Unidos,37,45,19,28,129,0,129
2014,3,Resto de América,25,105,58,52,240,0,240
2014,3,Resto del Mundo,105,255,50,32,442,0,442
2014,3,TOTAL,5893,8831,3472,1573,19769,0,19769
2014,4,España,3261,4122,1817,857,10057,0,10057
2014,4,Holanda,13,35,6,6,60,0,60
2014,4,Bélgica,28,44,12,22,106,0,106
2014,4,Alemania,236,232,63,93,624,0,624
2014,4,Francia,94,228,94,113,529,0,529
2014,4,Gran Bretaña,401,217,29,12,659,0,659
2014,4,Irlanda,24,19,13,6,62,0,62
2014,4,Italia,38,217,91,72,418,0,418
2014,4,Suecia,297,11,6,6,320,0,320
2014,4,Noruega,118,26,13,5,162,0,162
2014,4,Dinamarca,56,12,2,0,70,0,70
2014,4,Finlandia,72,24,11,2,109,0,109
2014,4,Suiza,69,41,8,31,149,0,149
2014,4,Austria,14,7,16,2,39,0,39
2014,4,Rusia,22,65,52,28,167,0,167
2014,4,Países del Este,24,50,28,20,122,0,122
2014,4,Resto de Europa,18,141,36,50,245,0,245
2014,4,Estados Unidos,19,33,8,5,65,0,65
2014,4,Resto de América,30,97,25,61,213,0,213
2014,4,Resto del Mundo,79,217,32,33,361,0,361
2014,4,TOTAL,4913,5838,2362,1424,14537,0,14537
2014,5,España,4133,5658,2014,759,12564,0,12564
2014,5,Holanda,13,17,15,5,50,0,50
2014,5,Bélgica,11,26,10,20,67,0,67
2014,5,Alemania,84,90,38,41,253,0,253
2014,5,Francia,103,221,87,43,454,0,454
2014,5,Gran Bretaña,166,153,42,7,368,0,368
2014,5,Irlanda,2,4,9,1,16,0,16
2014,5,Italia,49,184,92,59,384,0,384
2014,5,Suecia,15,0,8,5,28,0,28
2014,5,Noruega,26,11,0,0,37,0,37
2014,5,Dinamarca,6,16,4,0,26,0,26
2014,5,Finlandia,2,3,4,0,9,0,9
2014,5,Suiza,22,21,2,8,53,0,53
2014,5,Austria,3,21,2,3,29,0,29
2014,5,Rusia,41,46,24,8,119,0,119
2014,5,Países del Este,10,9,6,12,37,0,37
2014,5,Resto de Europa,29,108,58,42,237,0,237
2014,5,Estados Unidos,54,43,13,9,119,0,119
2014,5,Resto de América,12,95,43,44,194,0,194
2014,5,Resto del Mundo,58,101,34,10,203,0,203
2014,5,TOTAL,4839,6827,2505,1076,15247,0,15247
2014,6,España,3.544,4.821,1.725,784,10.874,0,10.874
2014,6,Holanda,8,154,3,11,176,0,176
2014,6,Bélgica,19,28,3,9,59,0,59
2014,6,Alemania,100,111,38,25,274,0,274
2014,6,Francia,65,107,42,61,275,0,275
2014,6,Gran Bretaña,117,237,10,19,383,0,383
2014,6,Irlanda,5,21,2,7,35,0,35
2014,6,Italia,50,152,84,42,328,0,328
2014,6,Suecia,15,10,0,7,32,0,32
2014,6,Noruega,16,2,3,0,21,0,21
2014,6,Dinamarca,14,2,5,5,26,0,26
2014,6,Finlandia,0,5,0,0,5,0,5
2014,6,Suiza,15,21,17,7,60,0,60
2014,6,Austria,5,3,5,4,17,0,17
2014,6,Rusia,17,26,8,14,65,0,65
2014,6,Países del Este,22,28,18,12,80,0,80
2014,6,Resto de Europa,12,82,45,42,181,0,181
2014,6,Estados Unidos,92,43,5,11,151,0,151
2014,6,Resto de América,22,93,45,40,200,0,200
2014,6,Resto del Mundo,60,205,16,26,307,0,307
2014,6,TOTAL,4.198,6.151,2.074,1.126,13.549,0,13.549
2014,7,España,3.844,4.981,1.451,904,11.180,0,11.180
2014,7,Holanda,20,37,13,12,82,0,82
2014,7,Bélgica,38,34,1,4,77,0,77
2014,7,Alemania,147,178,28,55,408,0,408
2014,7,Francia,131,152,43,98,424,0,424
2014,7,Gran Bretaña,241,311,20,1,573,0,573
2014,7,Irlanda,32,15,1,0,48,0,48
2014,7,Italia,51,222,47,26,346,0,346
2014,7,Suecia,18,21,0,10,49,0,49
2014,7,Noruega,23,32,4,0,59,0,59
2014,7,Dinamarca,24,11,3,7,45,0,45
2014,7,Finlandia,0,3,0,0,3,0,3
2014,7,Suiza,35,27,4,3,69,0,69
2014,7,Austria,13,42,2,3,60,0,60
2014,7,Rusia,31,48,12,3,94,0,94
2014,7,Países del Este,33,27,10,22,92,0,92
2014,7,Resto de Europa,30,105,40,30,205,0,205
2014,7,Estados Unidos,80,21,2,0,103,0,103
2014,7,Resto de América,22,77,64,34,197,0,197
2014,7,Resto del Mundo,74,132,21,29,256,0,256
2014,7,TOTAL,4.887,6.476,1.766,1.241,14.370,0,14.370
2014,8,España,2.909,3.685,1.254,870,8.718,0,8.718
2014,8,Holanda,24,25,4,13,66,0,66
2014,8,Bélgica,68,27,2,10,107,0,107
2014,8,Alemania,235,95,27,102,459,0,459
2014,8,Francia,144,259,53,148,604,0,604
2014,8,Gran Bretaña,293,164,23,12,492,0,492
2014,8,Irlanda,19,12,2,0,33,0,33
2014,8,Italia,105,417,304,151,977,0,977
2014,8,Suecia,12,15,1,5,33,0,33
2014,8,Noruega,18,10,1,0,29,0,29
2014,8,Dinamarca,8,19,0,9,36,0,36
2014,8,Finlandia,0,3,0,0,3,0,3
2014,8,Suiza,15,21,0,8,44,0,44
2014,8,Austria,11,8,5,8,32,0,32
2014,8,Rusia,40,49,11,20,120,0,120
2014,8,Países del Este,18,35,17,3,73,0,73
2014,8,Resto de Europa,32,86,39,25,182,0,182
2014,8,Estados Unidos,16,32,5,8,61,0,61
2014,8,Resto de América,19,91,54,47,211,0,211
2014,8,Resto del Mundo,48,191,18,63,320,0,320
2014,8,TOTAL,4.034,5.244,1.820,1.502,12.600,0,12.600
2014,9,España,3.427,5.130,2.077,823,11.457,0,11.457
2014,9,Holanda,16,29,13,0,58,0,58
2014,9,Bélgica,18,42,14,10,84,0,84
2014,9,Alemania,219,126,80,45,470,0,470
2014,9,Francia,57,129,72,63,321,0,321
2014,9,Gran Bretaña,268,375,39,12,694,0,694
2014,9,Irlanda,21,4,8,15,48,0,48
2014,9,Italia,86,215,147,103,551,0,551
2014,9,Suecia,20,15,5,0,40,0,40
2014,9,Noruega,14,20,0,0,34,0,34
2014,9,Dinamarca,8,8,8,2,26,0,26
2014,9,Finlandia,9,8,0,2,19,0,19
2014,9,Suiza,36,15,5,0,56,0,56
2014,9,Austria,5,6,4,5,20,0,20
2014,9,Rusia,19,63,45,3,130,0,130
2014,9,Países del Este,13,314,28,22,377,0,377
2014,9,Resto de Europa,18,101,53,60,232,0,232
2014,9,Estados Unidos,34,42,4,7,87,0,87
2014,9,Resto de América,25,83,33,56,197,0,197
2014,9,Resto del Mundo,84,252,30,23,389,0,389
2014,9,TOTAL,4.397,6.977,2.665,1.251,15.290,0,15.290
2014,10,España,4.235,6.777,2.427,883,14.322,0,14.322
2014,10,Holanda,55,52,10,14,131,0,131
2014,10,Bélgica,25,46,9,17,97,0,97
2014,10,Alemania,235,224,118,96,673,0,673
2014,10,Francia,172,367,79,88,706,0,706
2014,10,Gran Bretaña,324,153,19,16,512,0,512
2014,10,Irlanda,26,10,9,0,45,0,45
2014,10,Italia,82,191,146,72,491,0,491
2014,10,Suecia,198,50,12,0,260,0,260
2014,10,Noruega,171,34,17,3,225,0,225
2014,10,Dinamarca,88,113,9,1,211,0,211
2014,10,Finlandia,85,130,14,5,234,0,234
2014,10,Suiza,58,37,8,17,120,0,120
2014,10,Austria,9,14,5,4,32,0,32
2014,10,Rusia,47,29,32,8,116,0,116
2014,10,Países del Este,29,39,24,28,120,0,120
2014,10,Resto de Europa,23,291,49,66,429,0,429
2014,10,Estados Unidos,38,36,8,0,82,0,82
2014,10,Resto de América,46,109,63,29,247,0,247
2014,10,Resto del Mundo,93,174,29,37,333,0,333
2014,10,TOTAL,6.039,8.876,3.087,1.384,19.386,0,19.386
2014,11,España,4.006,6.069,2.507,735,13.317,0,13.317
2014,11,Holanda,11,56,36,13,116,0,116
2014,11,Bélgica,47,64,25,38,174,0,174
2014,11,Alemania,415,381,203,102,1.101,0,1.101
2014,11,Francia,109,265,181,119,674,0,674
2014,11,Gran Bretaña,355,312,73,14,754,0,754
2014,11,Irlanda,10,19,17,7,53,0,53
2014,11,Italia,73,276,165,69,583,0,583
2014,11,Suecia,492,98,23,7,620,0,620
2014,11,Noruega,338,49,26,3,416,0,416
2014,11,Dinamarca,119,51,12,1,183,0,183
2014,11,Finlandia,129,110,19,3,261,0,261
2014,11,Suiza,45,62,35,18,160,0,160
2014,11,Austria,17,37,21,4,79,0,79
2014,11,Rusia,63,47,71,20,201,0,201
2014,11,Países del Este,30,70,57,39,196,0,196
2014,11,Resto de Europa,33,174,127,56,390,0,390
2014,11,Estados Unidos,82,85,12,10,189,0,189
2014,11,Resto de América,26,130,73,34,263,0,263
2014,11,Resto del Mundo,87,309,54,43,493,0,493
2014,11,TOTAL,6.487,8.664,3.737,1.335,20.223,0,20.223
2014,12,España,3.470,5.320,2.572,801,12.163,0,12.163
2014,12,Holanda,33,85,48,12,178,0,178
2014,12,Bélgica,54,64,26,18,162,0,162
2014,12,Alemania,371,530,211,135,1.247,0,1.247
2014,12,Francia,86,274,174,114,648,0,648
2014,12,Gran Bretaña,412,344,102,37,895,0,895
2014,12,Irlanda,27,32,10,17,86,0,86
2014,12,Italia,68,248,183,93,592,0,592
2014,12,Suecia,422,132,48,10,612,0,612
2014,12,Noruega,295,88,41,8,432,0,432
2014,12,Dinamarca,84,84,14,17,199,0,199
2014,12,Finlandia,148,137,67,16,368,0,368
2014,12,Suiza,45,53,16,12,126,0,126
2014,12,Austria,18,25,10,10,63,0,63
2014,12,Rusia,80,118,50,17,265,0,265
2014,12,Países del Este,54,73,69,37,233,0,233
2014,12,Resto de Europa,18,223,136,69,446,0,446
2014,12,Estados Unidos,49,101,29,4,183,0,183
2014,12,Resto de América,56,109,82,39,286,0,286
2014,12,Resto del Mundo,95,345,53,29,522,0,522
2014,12,TOTAL,5.885,8.385,3.941,1.495,19.706,0,19.706
2014,13,España,44.471,63.019,24.411,9.524,141.425,0,141.425
2014,13,Holanda,303,676,227,162,1.368,0,1.368
2014,13,Bélgica,447,564,175,203,1.389,0,1.389
2014,13,Alemania,2.979,3.066,1.294,1.170,8.509,0,8.509
2014,13,Francia,1.344,2.778,1.221,1.215,6.558,0,6.558
2014,13,Gran Bretaña,3.946,3.572,640,344,8.502,0,8.502
2014,13,Irlanda,251,297,151,87,786,0,786
2014,13,Italia,843,2.952,1.706,1.008,6.509,0,6.509
2014,13,Suecia,2.679,727,216,108,3.730,0,3.730
2014,13,Noruega,1.442,783,194,43,2.462,0,2.462
2014,13,Dinamarca,612,606,91,84,1.393,0,1.393
2014,13,Finlandia,699,980,215,67,1.961,0,1.961
2014,13,Suiza,510,509,141,156,1.316,0,1.316
2014,13,Austria,185,309,135,79,708,0,708
2014,13,Rusia,582,946,503,257,2.288,0,2.288
2014,13,Países del Este,397,828,376,334,1.935,0,1.935
2014,13,Resto de Europa,329,1.873,882,636,3.720,0,3.720
2014,13,Estados Unidos,791,588,130,108,1.617,0,1.617
2014,13,Resto de América,358,1.282,701,516,2.857,0,2.857
2014,13,Resto del Mundo,1.000,2.701,437,406,4.544,0,4.544
2014,13,TOTAL,64.168,89.056,33.846,16.507,203.577,0,203.577
2015,1,España,3.053,5.141,2.204,611,11.009,0,11.009
2015,1,Holanda,15,83,45,24,167,0,167
2015,1,Bélgica,54,74,35,11,174,0,174
2015,1,Alemania,248,503,221,93,1.065,0,1.065
2015,1,Francia,98,205,146,118,567,0,567
2015,1,Reino Unido,480,707,113,89,1389,0,1389
2015,1,Irlanda,31,46,29,3,109,0,109
2015,1,Italia,64,268,233,100,665,0,665
2015,1,Suecia,511,121,44,7,683,0,683
2015,1,Noruega,337,49,30,14,430,0,430
2015,1,Dinamarca,88,97,29,6,220,0,220
2015,1,Finlandia,134,130,41,17,322,0,322
2015,1,Suiza,44,52,12,19,127,0,127
2015,1,Austria,20,44,17,7,88,0,88
2015,1,Rusia,34,95,77,39,245,0,245
2015,1,Países del Este,46,49,53,42,190,0,190
2015,1,Resto de Europa,34,428,115,77,654,0,654
2015,1,USA,38,70,4,6,118,0,118
2015,1,Resto de América,22,88,53,35,198,0,198
2015,1,Resto del Mundo,80,224,56,33,393,0,393
2015,1,TOTAL,5.431,8.474,3.557,1.351,18.813,0,18.813
2015,2,España,3.813,6.164,2.430,595,13.002,0,13.002
2015,2,Holanda,30,71,36,22,159,0,159
2015,2,Bélgica,40,55,40,9,144,0,144
2015,2,Alemania,342,418,178,128,1.066,0,1.066
2015,2,Francia,83,292,143,77,595,0,595
2015,2,Reino Unido,363,318,77,16,774,0,774
2015,2,Irlanda,22,58,38,2,120,0,120
2015,2,Italia,123,307,197,67,694,0,694
2015,2,Suecia,450,114,38,9,611,0,611
2015,2,Noruega,257,56,30,3,346,0,346
2015,2,Dinamarca,111,72,20,6,209,0,209
2015,2,Finlandia,141,94,25,6,266,0,266
2015,2,Suiza,42,48,20,11,121,0,121
2015,2,Austria,21,27,13,13,74,0,74
2015,2,Rusia,27,60,21,16,124,0,124
2015,2,Países del Este,34,44,48,37,163,0,163
2015,2,Resto de Europa,34,199,129,67,429,0,429
2015,2,USA,54,82,18,8,162,0,162
2015,2,Resto de América,14,92,53,33,192,0,192
2015,2,Resto del Mundo,73,283,49,27,432,0,432
2015,2,TOTAL,6.074,8.854,3.603,1.152,19.683,0,19.683
2015,3,España,4.124,6.045,2.306,730,13.205,0,13.205
2015,3,Holanda,25,44,27,13,109,0,109
2015,3,Bélgica,37,34,12,9,92,0,92
2015,3,Alemania,393,353,229,139,1114,0,1114
2015,3,Francia,124,207,120,118,569,0,569
2015,3,Reino Unido,379,212,62,16,669,0,669
2015,3,Irlanda,10,36,8,4,58,0,58
2015,3,Italia,76,341,146,69,632,0,632
2015,3,Suecia,463,59,35,3,560,0,560
2015,3,Noruega,283,53,14,3,353,0,353
2015,3,Dinamarca,106,61,13,3,183,0,183
2015,3,Finlandia,159,97,29,3,288,0,288
2015,3,Suiza,45,52,14,18,129,0,129
2015,3,Austria,9,36,28,17,90,0,90
2015,3,Rusia,10,60,24,29,123,0,123
2015,3,Países del Este,43,33,38,24,138,0,138
2015,3,Resto de Europa,31,334,99,38,502,0,502
2015,3,USA,31,49,11,10,101,0,101
2015,3,Resto de América,33,85,58,35,211,0,211
2015,3,Resto del Mundo,59,180,52,49,340,0,340
2015,3,TOTAL,6.440,8.371,3.325,1.330,19.466,0,19.466
2015,4,España,3.865,5.202,2.555,808,12.430,0,12.430
2015,4,Holanda,28,39,30,1,98,0,98
2015,4,Bélgica,46,64,31,2,143,0,143
2015,4,Alemania,200,185,117,55,557,0,557
2015,4,Francia,86,156,131,104,477,0,477
2015,4,Reino Unido,273,230,37,11,551,0,551
2015,4,Irlanda,32,32,7,1,72,0,72
2015,4,Italia,84,292,116,59,551,0,551
2015,4,Suecia,340,22,25,6,393,0,393
2015,4,Noruega,165,28,6,2,201,0,201
2015,4,Dinamarca,92,18,4,12,126,0,126
2015,4,Finlandia,91,44,7,3,145,0,145
2015,4,Suiza,36,37,13,9,95,0,95
2015,4,Austria,3,21,10,4,38,0,38
2015,4,Rusia,15,42,44,18,119,0,119
2015,4,Países del Este,29,53,21,4,107,0,107
2015,4,Resto de Europa,27,130,111,38,306,0,306
2015,4,USA,16,57,20,9,102,0,102
2015,4,Resto de América,18,52,37,19,126,0,126
2015,4,Resto del Mundo,71,210,23,24,328,0,328
2015,4,TOTAL,5.517,6.914,3.345,1.189,16.965,0,16.965
2015,5,España,4394,5849,2761,805,13809,0,13809
2015,5,Holanda,19,47,13,4,83,0,83
2015,5,Bélgica,29,23,14,0,66,0,66
2015,5,Alemania,282,284,90,30,686,0,686
2015,5,Francia,89,154,180,74,497,0,497
2015,5,Reino Unido,145,242,24,10,421,0,421
2015,5,Irlanda,12,9,13,1,35,0,35
2015,5,Italia,59,175,166,55,455,0,455
2015,5,Suecia,17,16,4,0,37,0,37
2015,5,Noruega,2,8,3,2,15,0,15
2015,5,Dinamarca,9,9,1,2,21,0,21
2015,5,Finlandia,20,9,1,2,32,0,32
2015,5,Suiza,39,23,10,10,82,0,82
2015,5,Austria,6,12,10,1,29,0,29
2015,5,Rusia,23,17,32,4,76,0,76
2015,5,Países del Este,13,25,7,13,58,0,58
2015,5,Resto de Europa,31,125,85,22,263,0,263
2015,5,USA,25,61,10,5,101,0,101
2015,5,Resto de América,20,106,87,27,240,0,240
2015,5,Resto del Mundo,108,126,21,25,280,0,280
2015,5,TOTAL,5342,7320,3532,1092,17286,0,17286
2015,6,España,4161,5155,2116,906,12338,0,12338
2015,6,Holanda,27,158,12,2,199,0,199
2015,6,Bélgica,25,21,12,6,64,0,64
2015,6,Alemania,102,149,72,29,352,0,352
2015,6,Francia,61,169,53,43,326,0,326
2015,6,Reino Unido,207,185,24,10,426,0,426
2015,6,Irlanda,24,21,12,4,61,0,61
2015,6,Italia,44,249,78,30,401,0,401
2015,6,Suecia,8,8,9,0,25,0,25
2015,6,Noruega,9,9,5,1,24,0,24
2015,6,Dinamarca,13,4,1,0,18,0,18
2015,6,Finlandia,1,12,0,0,13,0,13
2015,6,Suiza,27,31,3,0,61,0,61
2015,6,Austria,3,19,5,5,32,0,32
2015,6,Rusia,16,31,25,5,77,0,77
2015,6,Países del Este,30,42,21,13,106,0,106
2015,6,Resto de Europa,27,97,40,25,189,0,189
2015,6,USA,46,61,13,1,121,0,121
2015,6,Resto de América,19,115,46,43,223,0,223
2015,6,Resto del Mundo,85,216,43,31,375,0,375
2015,6,TOTAL,4935,6752,2590,1154,15431,0,15431
2015,7,España,5434,4597,1465,783,12279,0,12279
2015,7,Holanda,36,25,3,1,65,0,65
2015,7,Bélgica,60,22,0,4,86,0,86
2015,7,Alemania,268,90,28,19,405,0,405
2015,7,Francia,123,123,22,34,302,0,302
2015,7,Reino Unido,390,121,24,1,536,0,536
2015,7,Irlanda,27,19,9,4,59,0,59
2015,7,Italia,108,198,67,52,425,0,425
2015,7,Suecia,9,4,6,0,19,0,19
2015,7,Noruega,43,14,1,1,59,0,59
2015,7,Dinamarca,19,9,9,3,40,0,40
2015,7,Finlandia,5,1,0,0,6,0,6
2015,7,Suiza,25,29,1,0,55,0,55
2015,7,Austria,12,9,2,3,26,0,26
2015,7,Rusia,67,57,8,8,140,0,140
2015,7,Países del Este,64,30,15,15,124,0,124
2015,7,Resto de Europa,39,65,33,34,171,0,171
2015,7,USA,87,29,4,1,121,0,121
2015,7,Resto de América,81,106,53,49,289,0,289
2015,7,Resto del Mundo,181,122,28,37,368,0,368
2015,7,TOTAL,7078,5670,1778,1049,15575,0,15575
2015,8,España,4161,5155,2116,906,12338,0,12338
2015,8,Holanda,27,158,12,2,199,0,199
2015,8,Bélgica,25,21,12,6,64,0,64
2015,8,Alemania,102,149,72,29,352,0,352
2015,8,Francia,61,169,53,43,326,0,326
2015,8,Reino Unido,207,185,24,10,426,0,426
2015,8,Irlanda,24,21,12,4,61,0,61
2015,8,Italia,44,249,78,30,401,0,401
2015,8,Suecia,8,8,9,0,25,0,25
2015,8,Noruega,9,9,5,1,24,0,24
2015,8,Dinamarca,13,4,1,0,18,0,18
2015,8,Finlandia,1,12,0,0,13,0,13
2015,8,Suiza,27,31,3,0,61,0,61
2015,8,Austria,3,19,5,5,32,0,32
2015,8,Rusia,16,31,25,5,77,0,77
2015,8,Países del Este,30,42,21,13,106,0,106
2015,8,Resto de Europa,27,97,40,25,189,0,189
2015,8,USA,46,61,13,1,121,0,121
2015,8,Resto de América,19,115,46,43,223,0,223
2015,8,Resto del Mundo,85,216,43,31,375,0,375
2015,8,TOTAL,4935,6752,2590,1154,15431,0,15431
2015,9,España,4050,4215,2166,653,11084,0,11084
2015,9,Holanda,36,16,9,8,69,0,69
2015,9,Bélgica,18,66,22,9,115,0,115
2015,9,Alemania,245,134,126,40,545,0,545
2015,9,Francia,96,108,96,52,352,0,352
2015,9,Reino Unido,469,202,39,12,722,0,722
2015,9,Irlanda,12,19,5,2,38,0,38
2015,9,Italia,82,175,144,78,479,0,479
2015,9,Suecia,15,4,2,4,25,0,25
2015,9,Noruega,23,18,6,0,47,0,47
2015,9,Dinamarca,9,14,4,3,30,0,30
2015,9,Finlandia,7,2,8,0,17,0,17
2015,9,Suiza,16,20,8,3,47,0,47
2015,9,Austria,29,10,6,8,53,0,53
2015,9,Rusia,15,28,25,8,76,0,76
2015,9,Países del Este,32,41,29,17,119,0,119
2015,9,Resto de Europa,27,144,80,64,315,0,315
2015,9,USA,44,46,13,1,104,0,104
2015,9,Resto de América,30,148,50,27,255,0,255
2015,9,Resto del Mundo,116,134,32,23,305,0,305
2015,9,TOTAL,5371,5544,2870,1012,14797,0,14797
2015,10,España,5986,5122,2349,843,14300,0,14300
2015,10,Holanda,60,37,22,19,138,0,138
2015,10,Bélgica,57,32,4,4,97,0,97
2015,10,Alemania,459,227,107,56,849,0,849
2015,10,Francia,165,151,124,83,523,0,523
2015,10,Reino Unido,597,246,21,14,878,0,878
2015,10,Irlanda,18,23,10,1,52,0,52
2015,10,Italia,117,201,142,71,531,0,531
2015,10,Suecia,281,18,12,10,321,0,321
2015,10,Noruega,219,27,2,0,248,0,248
2015,10,Dinamarca,111,12,4,24,151,0,151
2015,10,Finlandia,121,25,12,5,163,0,163
2015,10,Suiza,99,56,15,11,181,0,181
2015,10,Austria,28,17,8,11,64,0,64
2015,10,Rusia,36,12,33,9,90,0,90
2015,10,Países del Este,46,16,21,9,92,0,92
2015,10,Resto de Europa,41,117,105,60,323,0,323
2015,10,USA,65,67,22,1,155,0,155
2015,10,Resto de América,69,132,64,24,289,0,289
2015,10,Resto del Mundo,200,132,45,25,402,0,402
2015,10,TOTAL,8775,6670,3122,1280,19847,0,19847
2015,11,España,6159,5355,2808,699,15021,0,15021
2015,11,Holanda,54,35,21,9,119,0,119
2015,11,Bélgica,69,32,18,14,133,0,133
2015,11,Alemania,472,288,134,87,981,0,981
2015,11,Francia,169,167,136,109,581,0,581
2015,11,Reino Unido,654,215,72,24,965,0,965
2015,11,Irlanda,40,21,36,9,106,0,106
2015,11,Italia,153,249,173,91,666,0,666
2015,11,Suecia,326,12,38,1,377,0,377
2015,11,Noruega,268,27,14,9,318,0,318
2015,11,Dinamarca,97,26,9,11,143,0,143
2015,11,Finlandia,235,65,28,2,330,0,330
2015,11,Suiza,79,66,9,16,170,0,170
2015,11,Austria,34,33,21,6,94,0,94
2015,11,Rusia,57,26,53,15,151,0,151
2015,11,Países del Este,105,26,54,25,210,0,210
2015,11,Resto de Europa,74,183,149,71,477,0,477
2015,11,USA,163,70,25,4,262,0,262
2015,11,Resto de América,69,144,95,31,339,0,339
2015,11,Resto del Mundo,232,121,40,14,407,0,407
2015,11,TOTAL,9509,7161,3933,1247,21850,0,21850
2015,12,España,5189,4574,2321,683,12767,0,12767
2015,12,Holanda,65,72,33,18,188,0,188
2015,12,Bélgica,61,53,26,6,146,0,146
2015,12,Alemania,457,365,233,87,1142,0,1142
2015,12,Francia,172,191,119,77,559,0,559
2015,12,Reino Unido,591,283,91,25,990,0,990
2015,12,Irlanda,59,19,28,5,111,0,111
2015,12,Italia,202,260,193,68,723,0,723
2015,12,Suecia,359,43,41,6,449,0,449
2015,12,Noruega,260,34,15,1,310,0,310
2015,12,Dinamarca,97,37,29,6,169,0,169
2015,12,Finlandia,204,85,46,8,343,0,343
2015,12,Suiza,97,96,19,14,226,0,226
2015,12,Austria,50,34,12,11,107,0,107
2015,12,Rusia,42,67,15,28,152,0,152
2015,12,Países del Este,77,34,80,18,209,0,209
2015,12,Resto de Europa,106,208,98,91,503,0,503
2015,12,USA,55,71,14,5,145,0,145
2015,12,Resto de América,60,157,63,14,294,0,294
2015,12,Resto del Mundo,313,208,66,35,622,0,622
2015,12,TOTAL,8516,6891,3542,1206,20155,0,20155
2015,13,España,54389,62574,27597,9022,153582,0,153582
2015,13,Holanda,422,785,263,123,1593,0,1593
2015,13,Bélgica,521,497,226,80,1324,0,1324
2015,13,Alemania,3570,3145,1607,792,9114,0,9114
2015,13,Francia,1327,2092,1323,932,5674,0,5674
2015,13,Reino Unido,4755,3146,608,238,8747,0,8747
2015,13,Irlanda,311,324,207,40,882,0,882
2015,13,Italia,1156,2964,1733,770,6623,0,6623
2015,13,Suecia,2787,429,263,46,3525,0,3525
2015,13,Noruega,1875,332,131,37,2375,0,2375
2015,13,Dinamarca,765,363,124,76,1328,0,1328
2015,13,Finlandia,1119,576,197,46,1938,0,1938
2015,13,Suiza,576,541,127,111,1355,0,1355
2015,13,Austria,218,281,137,91,727,0,727
2015,13,Rusia,358,526,382,184,1450,0,1450
2015,13,Países del Este,549,435,408,230,1622,0,1622
2015,13,Resto de Europa,498,2127,1084,612,4321,0,4321
2015,13,USA,670,724,167,52,1613,0,1613
2015,13,Resto de América,454,1340,705,380,2879,0,2879
2015,13,Resto del Mundo,1603,2172,498,354,4627,0,4627
2015,13,TOTAL,77923,85373,37787,14216,215299,0,215299
2016,1,España,5396,4730,2406,670,13202,0,13202
2016,1,Holanda,46,55,52,16,169,25,194
2016,1,Bélgica,77,47,23,11,158,0,158
2016,1,Alemania,445,382,154,101,1082,25,1107
2016,1,Francia,214,201,155,80,650,0,650
2016,1,Reino Unido,689,385,95,72,1241,0,1241
2016,1,Irlanda,72,35,38,4,149,0,149
2016,1,Italia,199,343,206,150,898,0,898
2016,1,Suecia,337,49,26,11,423,0,423
2016,1,Noruega,231,29,18,4,282,0,282
2016,1,Dinamarca,96,31,22,7,156,0,156
2016,1,Finlandia,157,92,44,28,321,0,321
2016,1,Suiza,60,65,17,7,149,0,149
2016,1,Austria,40,45,21,14,120,0,120
2016,1,Rusia,67,54,60,28,209,0,209
2016,1,Países del Este,82,27,62,12,183,0,183
2016,1,Resto de Europa,64,210,135,116,525,0,525
2016,1,USA,49,65,26,7,147,0,147
2016,1,Resto de América,26,85,83,21,215,0,215
2016,1,Resto del Mundo,194,172,71,32,469,0,469
2016,1,TOTAL,8541,7102,3714,1391,20748,50,20798
2016,2,España,6078,5476,2520,925,14999,0,14999
2016,2,Holanda,41,71,35,34,181,0,181
2016,2,Bélgica,42,36,29,17,124,0,124
2016,2,Alemania,419,363,127,100,1009,41,1050
2016,2,Francia,202,278,171,126,777,25,802
2016,2,Reino Unido,713,392,110,34,1249,0,1249
2016,2,Irlanda,93,66,19,2,180,0,180
2016,2,Italia,142,264,178,56,640,0,640
2016,2,Suecia,317,91,29,16,453,0,453
2016,2,Noruega,266,46,17,3,332,0,332
2016,2,Dinamarca,120,42,23,8,193,0,193
2016,2,Finlandia,156,53,22,9,240,0,240
2016,2,Suiza,80,39,15,11,145,0,145
2016,2,Austria,30,46,8,17,101,0,101
2016,2,Rusia,63,43,32,16,154,0,154
2016,2,Países del Este,109,67,50,30,256,0,256
2016,2,Resto de Europa,100,360,131,73,664,0,664
2016,2,USA,112,68,32,11,223,0,223
2016,2,Resto de América,49,117,43,28,237,0,237
2016,2,Resto del Mundo,265,178,44,17,504,0,504
2016,2,TOTAL,9397,8096,3635,1533,22661,66,22727
2016,3,España,6546,4939,2763,905,15153,0,15153
2016,3,Holanda,52,24,33,15,124,33,157
2016,3,Bélgica,76,60,10,6,152,0,152
2016,3,Alemania,689,316,198,146,1349,25,1374
2016,3,Francia,350,261,125,57,793,0,793
2016,3,Reino Unido,834,283,55,32,1204,0,1204
2016,3,Irlanda,41,42,13,2,98,0,98
2016,3,Italia,293,241,184,69,787,0,787
2016,3,Suecia,519,43,17,9,588,0,588
2016,3,Noruega,217,24,14,2,257,0,257
2016,3,Dinamarca,106,117,13,14,250,0,250
2016,3,Finlandia,199,82,22,7,310,0,310
2016,3,Suiza,68,56,23,26,173,0,173
2016,3,Austria,37,30,25,4,96,0,96
2016,3,Rusia,27,59,49,32,167,0,167
2016,3,Países del Este,131,58,52,33,274,0,274
2016,3,Resto de Europa,66,183,114,90,453,0,453
2016,3,USA,75,60,9,5,149,0,149
2016,3,Resto de América,39,125,43,32,239,0,239
2016,3,Resto del Mundo,244,154,28,33,459,0,459
2016,3,TOTAL,10609,7157,3790,1519,23075,58,23133
2016,4,España,5476,5039,2496,710,13721,0,13721
2016,4,Holanda,34,59,19,31,143,0,143
2016,4,Bélgica,54,27,13,4,98,0,98
2016,4,Alemania,328,144,83,41,596,33,629
2016,4,Francia,469,235,159,84,947,33,980
2016,4,Reino Unido,411,193,53,16,673,17,690
2016,4,Irlanda,41,23,8,8,80,0,80
2016,4,Italia,132,224,130,72,558,0,558
2016,4,Suecia,316,24,22,1,363,0,363
2016,4,Noruega,181,12,2,3,198,0,198
2016,4,Dinamarca,85,22,4,2,113,0,113
2016,4,Finlandia,140,21,12,17,190,0,190
2016,4,Suiza,38,32,22,8,100,0,100
2016,4,Austria,23,15,8,1,47,0,47
2016,4,Rusia,28,52,50,3,133,0,133
2016,4,Países del Este,105,11,27,40,183,0,183
2016,4,Resto de Europa,64,188,119,46,417,0,417
2016,4,USA,136,87,8,1,232,0,232
2016,4,Resto de América,82,133,87,19,321,0,321
2016,4,Resto del Mundo,268,105,35,17,425,0,425
2016,4,TOTAL,8411,6646,3357,1124,19538,83,19621
2016,5,España,5869,5198,2333,745,14145,0,14145
2016,5,Holanda,20,21,17,12,70,0,70
2016,5,Bélgica,45,27,10,6,88,0,88
2016,5,Alemania,272,118,49,35,474,33,507
2016,5,Francia,136,141,80,82,439,0,439
2016,5,Reino Unido,306,122,38,16,482,0,482
2016,5,Irlanda,17,6,8,4,35,0,35
2016,5,Italia,120,192,108,69,489,0,489
2016,5,Suecia,45,9,5,2,61,0,61
2016,5,Noruega,13,5,9,2,29,0,29
2016,5,Dinamarca,109,25,3,0,137,0,137
2016,5,Finlandia,28,6,4,2,40,0,40
2016,5,Suiza,125,12,9,6,152,0,152
2016,5,Austria,5,4,6,6,21,0,21
2016,5,Rusia,38,25,28,22,113,0,113
2016,5,Países del Este,54,45,24,25,148,0,148
2016,5,Resto de Europa,98,167,124,73,462,0,462
2016,5,USA,117,40,17,2,176,0,176
2016,5,Resto de América,53,194,111,20,378,0,378
2016,5,Resto del Mundo,134,206,52,14,406,0,406
2016,5,TOTAL,7604,6563,3035,1143,18345,33,18378
2016,6,España,5868,5245,2226,773,14112,0,14112
2016,6,Holanda,46,23,6,11,86,0,86
2016,6,Bélgica,48,15,4,35,102,0,102
2016,6,Alemania,144,94,42,27,307,0,307
2016,6,Francia,89,114,50,67,320,0,320
2016,6,Reino Unido,214,148,22,12,396,0,396
2016,6,Irlanda,8,13,5,1,27,0,27
2016,6,Italia,123,156,104,28,411,0,411
2016,6,Suecia,18,14,9,9,50,0,50
2016,6,Noruega,13,0,2,2,17,0,17
2016,6,Dinamarca,4,4,1,1,10,0,10
2016,6,Finlandia,3,5,0,2,10,0,10
2016,6,Suiza,18,13,5,16,52,0,52
2016,6,Austria,19,7,5,1,32,0,32
2016,6,Rusia,28,27,14,6,75,0,75
2016,6,Países del Este,54,27,18,25,124,0,124
2016,6,Resto de Europa,91,123,74,40,328,0,328
2016,6,USA,95,71,13,11,190,0,190
2016,6,Resto de América,107,109,70,36,322,0,322
2016,6,Resto del Mundo,128,120,46,14,308,0,308
2016,6,TOTAL,7118,6328,2716,1117,17279,0,17279
2016,7,España,5753,4987,1878,876,13494,137,13631
2016,7,Holanda,59,49,5,1,114,0,114
2016,7,Bélgica,68,35,8,15,126,0,126
2016,7,Alemania,253,125,46,44,468,0,468
2016,7,Francia,179,176,47,69,471,0,471
2016,7,Reino Unido,565,179,116,12,872,0,872
2016,7,Irlanda,133,50,2,0,185,0,185
2016,7,Italia,109,215,40,73,437,0,437
2016,7,Suecia,36,34,2,3,75,0,75
2016,7,Noruega,17,22,1,0,40,0,40
2016,7,Dinamarca,22,15,9,1,47,0,47
2016,7,Finlandia,12,8,0,0,20,0,20
2016,7,Suiza,46,25,5,1,77,0,77
2016,7,Austria,13,22,0,4,39,0,39
2016,7,Rusia,29,54,6,3,92,307,399
2016,7,Países del Este,92,43,35,5,175,0,175
2016,7,Resto de Europa,229,111,49,54,443,0,443
2016,7,USA,149,72,16,9,246,0,246
2016,7,Resto de América,77,124,72,41,314,0,314
2016,7,Resto del Mundo,261,140,36,25,462,0,462
2016,7,TOTAL,8102,6486,2373,1236,18197,444,18641
2016,8,España,4808,3841,1797,711,11157,0,11157
2016,8,Holanda,132,45,4,1,182,0,182
2016,8,Bélgica,120,19,5,9,153,0,153
2016,8,Alemania,447,195,38,30,710,0,710
2016,8,Francia,205,220,67,46,538,0,538
2016,8,Reino Unido,689,215,16,7,927,0,927
2016,8,Irlanda,22,47,6,4,79,0,79
2016,8,Italia,220,412,383,94,1109,0,1109
2016,8,Suecia,29,15,2,1,47,0,47
2016,8,Noruega,39,12,1,0,52,0,52
2016,8,Dinamarca,8,2,1,1,12,0,12
2016,8,Finlandia,8,3,3,0,14,0,14
2016,8,Suiza,58,21,0,1,80,0,80
2016,8,Austria,20,13,3,1,37,0,37
2016,8,Rusia,49,30,8,12,99,0,99
2016,8,Países del Este,130,40,25,7,202,0,202
2016,8,Resto de Europa,88,135,68,50,341,0,341
2016,8,USA,66,41,13,8,128,0,128
2016,8,Resto de América,68,122,52,36,278,0,278
2016,8,Resto del Mundo,341,166,47,29,583,0,583
2016,8,TOTAL,7547,5594,2539,1048,16728,0,16728
2016,9,España,5093,4604,2521,698,12916,0,12916
2016,9,Holanda,256,115,17,3,391,0,391
2016,9,Bélgica,30,22,15,5,72,0,72
2016,9,Alemania,293,190,76,38,597,0,597
2016,9,Francia,113,144,95,16,368,0,368
2016,9,Reino Unido,492,212,59,9,772,0,772
2016,9,Irlanda,12,17,6,11,46,0,46
2016,9,Italia,185,242,146,73,646,0,646
2016,9,Suecia,21,14,10,0,45,0,45
2016,9,Noruega,37,15,3,0,55,0,55
2016,9,Dinamarca,38,27,9,3,77,0,77
2016,9,Finlandia,10,10,0,0,20,0,20
2016,9,Suiza,35,35,9,3,82,0,82
2016,9,Austria,9,39,9,0,57,0,57
2016,9,Rusia,55,25,28,12,120,0,120
2016,9,Países del Este,90,37,30,15,172,0,172
2016,9,Resto de Europa,88,153,155,54,450,0,450
2016,9,USA,86,56,1,5,148,0,148
2016,9,Resto de América,75,183,44,22,324,0,324
2016,9,Resto del Mundo,223,168,64,17,472,0,472
2016,9,TOTAL,7241,6308,3297,984,17830,0,17830
2016,10,España,6016,5073,2681,676,14446,0,14446
2016,10,Holanda,83,85,27,8,203,0,203
2016,10,Bélgica,61,46,25,3,135,0,135
2016,10,Alemania,426,201,94,28,749,0,749
2016,10,Francia,170,167,133,57,527,0,527
2016,10,Reino Unido,516,340,30,12,898,0,898
2016,10,Irlanda,37,17,9,5,68,0,68
2016,10,Italia,110,215,134,95,554,0,554
2016,10,Suecia,237,19,12,3,271,0,271
2016,10,Noruega,193,20,8,5,226,0,226
2016,10,Dinamarca,116,14,5,1,136,0,136
2016,10,Finlandia,80,10,10,0,100,0,100
2016,10,Suiza,80,40,14,7,141,0,141
2016,10,Austria,27,10,11,3,51,0,51
2016,10,Rusia,28,42,40,8,118,0,118
2016,10,Países del Este,83,25,18,20,146,0,146
2016,10,Resto de Europa,77,186,123,44,430,0,430
2016,10,USA,57,67,12,3,139,0,139
2016,10,Resto de América,74,131,62,25,292,0,292
2016,10,Resto del Mundo,225,129,45,26,425,0,425
2016,10,TOTAL,8696,6837,3493,1029,20055,0,20055
2016,11,España,6323,5470,2533,728,15054,0,15054
2016,11,Holanda,73,65,49,11,198,0,198
2016,11,Bélgica,83,47,24,11,165,0,165
2016,11,Alemania,434,262,191,37,924,0,924
2016,11,Francia,185,223,100,46,554,0,554
2016,11,Reino Unido,510,273,96,28,907,0,907
2016,11,Irlanda,36,21,26,4,87,0,87
2016,11,Italia,158,269,163,78,668,0,668
2016,11,Suecia,286,25,28,8,347,0,347
2016,11,Noruega,219,32,4,1,256,0,256
2016,11,Dinamarca,71,13,22,3,109,0,109
2016,11,Finlandia,227,52,22,5,306,0,306
2016,11,Suiza,59,43,18,5,125,0,125
2016,11,Austria,27,24,15,4,70,0,70
2016,11,Rusia,85,51,67,21,224,0,224
2016,11,Países del Este,110,28,67,9,214,0,214
2016,11,Resto de Europa,146,177,163,83,569,0,569
2016,11,USA,127,51,14,3,195,0,195
2016,11,Resto de América,131,171,64,41,407,0,407
2016,11,Resto del Mundo,94,158,40,13,305,0,305
2016,11,TOTAL,9384,7455,3706,1139,21684,0,21684
2016,12,España,4893,4422,2441,554,12310,0,12310
2016,12,Holanda,99,81,41,24,245,0,245
2016,12,Bélgica,41,60,25,12,138,0,138
2016,12,Alemania,386,392,179,83,1040,0,1040
2016,12,Francia,138,144,96,53,431,0,431
2016,12,Reino Unido,480,434,118,46,1078,0,1078
2016,12,Irlanda,34,33,26,9,102,0,102
2016,12,Italia,133,339,222,71,765,0,765
2016,12,Suecia,345,41,38,9,433,0,433
2016,12,Noruega,239,38,19,12,308,0,308
2016,12,Dinamarca,102,36,19,7,164,0,164
2016,12,Finlandia,119,74,26,8,227,0,227
2016,12,Suiza,91,49,19,7,166,0,166
2016,12,Austria,30,26,10,4,70,0,70
2016,12,Rusia,40,100,40,21,201,0,201
2016,12,Países del Este,59,68,63,25,215,0,215
2016,12,Resto de Europa,96,158,139,59,452,0,452
2016,12,USA,98,106,33,1,238,0,238
2016,12,Resto de América,33,171,73,34,311,0,311
2016,12,Resto del Mundo,105,291,68,34,498,0,498
2016,12,TOTAL,7561,7063,3695,1073,19392,0,19392
2016,13,España,68119,59024,28595,8971,164709,137,164846
2016,13,Holanda,941,693,305,167,2106,58,2164
2016,13,Bélgica,745,441,191,134,1511,0,1511
2016,13,Alemania,4536,2782,1277,710,9305,157,9462
2016,13,Francia,2450,2304,1278,783,6815,58,6873
2016,13,Reino Unido,6419,3176,808,296,10699,17,10716
2016,13,Irlanda,546,370,166,54,1136,0,1136
2016,13,Italia,1924,3112,1998,928,7962,0,7962
2016,13,Suecia,2506,378,200,72,3156,0,3156
2016,13,Noruega,1665,255,98,34,2052,0,2052
2016,13,Dinamarca,877,348,131,48,1404,0,1404
2016,13,Finlandia,1139,416,165,78,1798,0,1798
2016,13,Suiza,758,430,156,98,1442,0,1442
2016,13,Austria,280,281,121,59,741,0,741
2016,13,Rusia,537,562,422,184,1705,307,2012
2016,13,Países del Este,1099,476,471,246,2292,0,2292
2016,13,Resto de Europa,1207,2151,1394,782,5534,0,5534
2016,13,USA,1167,784,194,66,2211,0,2211
2016,13,Resto de América,814,1665,804,355,3638,0,3638
2016,13,Resto del Mundo,2482,1987,576,271,5316,0,5316
2016,13,TOTAL,100211,81635,39350,14336,235532,734,236266
2017,1,España,5513,4375,2248,538,12674,0,12674
2017,1,Holanda,101,84,52,7,244,0,244
2017,1,Bélgica,100,64,26,4,194,0,194
2017,1,Alemania,429,321,155,71,976,0,976
2017,1,Francia,145,162,123,73,503,0,503
2017,1,Reino Unido,700,480,116,45,1341,0,1341
2017,1,Irlanda,57,45,26,9,137,0,137
2017,1,Italia,209,337,227,98,871,0,871
2017,1,Suecia,427,89,43,7,566,0,566
2017,1,Noruega,246,34,19,7,306,0,306
2017,1,Dinamarca,123,78,9,16,226,0,226
2017,1,Finlandia,200,77,55,18,350,0,350
2017,1,Suiza,93,40,26,4,163,0,163
2017,1,Austria,33,24,21,4,82,0,82
2017,1,Rusia,90,74,57,30,251,0,251
2017,1,Países del Este,168,65,103,3,339,0,339
2017,1,Resto de Europa,173,236,173,132,714,0,714
2017,1,USA,56,90,24,8,178,0,178
2017,1,Resto de América,69,128,89,21,307,0,307
2017,1,Resto del Mundo,144,180,51,25,400,0,400
2017,1,TOTAL,9076,6983,3643,1120,20822,0,20822
2017,2,España,5522,5090,2554,620,13786,0,13786
2017,2,Holanda,95,66,41,25,227,0,227
2017,2,Bélgica,71,64,21,5,161,0,161
2017,2,Alemania,479,285,126,42,932,0,932
2017,2,Francia,242,213,160,69,684,0,684
2017,2,Reino Unido,652,376,154,38,1220,0,1220
2017,2,Irlanda,90,31,12,1,134,0,134
2017,2,Italia,168,263,149,83,663,0,663
2017,2,Suecia,362,56,30,4,452,0,452
2017,2,Noruega,212,26,2,7,247,0,247
2017,2,Dinamarca,113,41,13,8,175,0,175
2017,2,Finlandia,186,56,8,9,259,0,259
2017,2,Suiza,82,49,16,9,156,0,156
2017,2,Austria,37,32,23,11,103,0,103
2017,2,Rusia,61,61,47,9,178,0,178
2017,2,Países del Este,101,41,63,20,225,0,225
2017,2,Resto de Europa,317,243,126,59,745,0,745
2017,2,USA,54,91,33,0,178,0,178
2017,2,Resto de América,92,124,54,16,286,0,286
2017,2,Resto del Mundo,225,238,66,28,557,0,557
2017,2,TOTAL,9161,7446,3698,1063,21368,0,21368
2017,3,España,6365,5923,3156,709,16153,0,16153
2017,3,Holanda,102,41,21,5,169,0,169
2017,3,Bélgica,68,45,22,8,143,0,143
2017,3,Alemania,495,261,180,74,1010,0,1010
2017,3,Francia,183,217,99,55,554,0,554
2017,3,Reino Unido,791,358,64,73,1286,0,1286
2017,3,Irlanda,46,54,16,5,121,0,121
2017,3,Italia,191,323,125,83,722,0,722
2017,3,Suecia,359,62,24,4,449,0,449
2017,3,Noruega,302,57,18,1,378,0,378
2017,3,Dinamarca,91,23,8,7,129,0,129
2017,3,Finlandia,211,37,31,3,282,0,282
2017,3,Suiza,59,36,6,4,105,0,105
2017,3,Austria,20,16,17,7,60,0,60
2017,3,Rusia,26,40,38,13,117,0,117
2017,3,Países del Este,145,68,38,24,275,0,275
2017,3,Resto de Europa,158,179,204,71,612,0,612
2017,3,USA,162,70,58,12,302,0,302
2017,3,Resto de América,101,136,53,18,308,0,308
2017,3,Resto del Mundo,257,233,35,20,545,0,545
2017,3,TOTAL,10132,8179,4213,1196,23720,0,23720
2017,4,España,4901,4458,2755,686,12800,0,12800
2017,4,Holanda,55,32,19,1,107,0,107
2017,4,Bélgica,81,32,38,1,152,0,152
2017,4,Alemania,325,157,110,37,629,0,629
2017,4,Francia,261,229,126,50,666,0,666
2017,4,Reino Unido,607,189,38,21,855,0,855
2017,4,Irlanda,68,27,11,1,107,0,107
2017,4,Italia,197,229,178,50,654,0,654
2017,4,Suecia,282,16,27,1,326,0,326
2017,4,Noruega,169,24,8,4,205,0,205
2017,4,Dinamarca,94,186,3,0,283,0,283
2017,4,Finlandia,144,25,9,4,182,0,182
2017,4,Suiza,87,28,8,36,159,0,159
2017,4,Austria,31,25,10,0,66,0,66
2017,4,Rusia,38,40,47,17,142,0,142
2017,4,Países del Este,134,60,30,11,235,0,235
2017,4,Resto de Europa,167,227,92,58,544,0,544
2017,4,USA,154,108,24,21,307,0,307
2017,4,Resto de América,118,128,63,28,337,0,337
2017,4,Resto del Mundo,200,275,33,20,528,0,528
2017,4,TOTAL,8113,6495,3629,1047,19284,0,19284
2017,5,España,5588,5164,2754,740,14246,0,14246
2017,5,Holanda,44,24,8,0,76,0,76
2017,5,Bélgica,40,37,16,1,94,0,94
2017,5,Alemania,190,108,54,20,372,0,372
2017,5,Francia,175,191,124,33,523,0,523
2017,5,Reino Unido,358,122,30,3,513,0,513
2017,5,Irlanda,19,20,6,0,45,0,45
2017,5,Italia,106,231,74,75,486,0,486
2017,5,Suecia,13,19,5,4,41,0,41
2017,5,Noruega,15,6,3,1,25,0,25
2017,5,Dinamarca,19,6,1,0,26,0,26
2017,5,Finlandia,12,14,5,1,32,0,32
2017,5,Suiza,57,13,5,5,80,0,80
2017,5,Austria,19,7,2,1,29,0,29
2017,5,Rusia,32,45,26,7,110,0,110
2017,5,Países del Este,64,32,21,25,142,0,142
2017,5,Resto de Europa,107,139,90,53,389,0,389
2017,5,USA,95,64,12,1,172,0,172
2017,5,Resto de América,92,145,51,37,325,0,325
2017,5,Resto del Mundo,112,177,28,21,338,0,338
2017,5,TOTAL,7157,6564,3315,1028,18064,0,18064
2017,6,España,5665,5144,2495,624,13928,0,13928
2017,6,Holanda,34,64,14,5,117,0,117
2017,6,Bélgica,53,38,9,0,100,0,100
2017,6,Alemania,169,105,54,11,339,0,339
2017,6,Francia,94,100,66,9,269,0,269
2017,6,Reino Unido,362,144,19,20,545,0,545
2017,6,Irlanda,35,21,5,5,66,0,66
2017,6,Italia,94,171,92,26,383,0,383
2017,6,Suecia,33,17,4,3,57,0,57
2017,6,Noruega,39,5,2,1,47,0,47
2017,6,Dinamarca,5,7,0,0,12,0,12
2017,6,Finlandia,5,6,2,0,13,0,13
2017,6,Suiza,27,24,5,0,56,0,56
2017,6,Austria,14,3,0,0,17,0,17
2017,6,Rusia,36,27,16,16,95,0,95
2017,6,Países del Este,68,52,13,16,149,0,149
2017,6,Resto de Europa,199,89,82,38,408,0,408
2017,6,USA,74,77,36,16,203,0,203
2017,6,Resto de América,92,150,60,21,323,0,323
2017,6,Resto del Mundo,225,131,49,16,421,0,421
2017,6,TOTAL,7323,6375,3023,827,17548,0,17548
2017,7,España,6019,5305,2713,839,14876,0,14876
2017,7,Holanda,36,44,5,0,85,0,85
2017,7,Bélgica,99,46,4,1,150,0,150
2017,7,Alemania,193,124,40,16,373,0,373
2017,7,Francia,235,177,64,22,498,0,498
2017,7,Reino Unido,343,166,24,16,549,0,549
2017,7,Irlanda,33,25,8,0,66,0,66
2017,7,Italia,134,217,84,45,480,0,480
2017,7,Suecia,22,11,6,7,46,0,46
2017,7,Noruega,37,12,5,0,54,0,54
2017,7,Dinamarca,7,16,2,0,25,0,25
2017,7,Finlandia,0,9,0,9,18,0,18
2017,7,Suiza,44,18,5,4,71,0,71
2017,7,Austria,10,6,4,1,21,0,21
2017,7,Rusia,22,35,21,1,79,0,79
2017,7,Países del Este,81,40,8,3,132,0,132
2017,7,Resto de Europa,122,143,44,32,341,0,341
2017,7,USA,130,104,16,0,250,0,250
2017,7,Resto de América,157,197,69,49,472,0,472
2017,7,Resto del Mundo,132,148,14,28,322,0,322
2017,7,TOTAL,7856,6843,3136,1073,18908,0,18908
2017,8,España,4657,3978,2535,672,11842,0,11842
2017,8,Holanda,54,25,3,0,82,0,82
2017,8,Bélgica,224,21,16,3,264,0,264
2017,8,Alemania,281,188,73,22,564,0,564
2017,8,Francia,377,192,102,45,716,0,716
2017,8,Reino Unido,836,124,13,13,986,0,986
2017,8,Irlanda,33,21,9,0,63,0,63
2017,8,Italia,218,400,398,84,1100,0,1100
2017,8,Suecia,18,15,3,0,36,0,36
2017,8,Noruega,15,18,7,0,40,0,40
2017,8,Dinamarca,17,8,1,0,26,0,26
2017,8,Finlandia,1,4,1,0,6,0,6
2017,8,Suiza,29,17,3,1,50,0,50
2017,8,Austria,15,13,9,1,38,0,38
2017,8,Rusia,43,40,14,4,101,0,101
2017,8,Países del Este,84,58,37,12,191,0,191
2017,8,Resto de Europa,285,165,64,33,547,0,547
2017,8,USA,70,41,9,4,124,0,124
2017,8,Resto de América,78,148,54,34,314,0,314
2017,8,Resto del Mundo,226,131,46,15,418,0,418
2017,8,TOTAL,7561,5607,3397,943,17508,0,17508
2017,9,España,5551,5092,3341,822,14806,0,14806
2017,9,Holanda,37,50,19,7,113,0,113
2017,9,Bélgica,78,36,17,4,135,0,135
2017,9,Alemania,567,264,137,13,981,0,981
2017,9,Francia,198,156,83,16,453,0,453
2017,9,Reino Unido,495,136,21,11,663,0,663
2017,9,Irlanda,27,31,12,1,71,0,71
2017,9,Italia,115,228,140,37,520,0,520
2017,9,Suecia,39,21,6,3,69,0,69
2017,9,Noruega,62,14,2,1,79,0,79
2017,9,Dinamarca,22,7,1,0,30,0,30
2017,9,Finlandia,16,7,2,0,25,0,25
2017,9,Suiza,61,19,2,9,91,0,91
2017,9,Austria,30,26,2,3,61,0,61
2017,9,Rusia,138,118,43,4,303,0,303
2017,9,Países del Este,69,53,33,12,167,0,167
2017,9,Resto de Europa,115,144,122,46,427,0,427
2017,9,USA,87,35,22,3,147,0,147
2017,9,Resto de América,126,147,91,51,415,0,415
2017,9,Resto del Mundo,147,155,40,15,357,0,357
2017,9,TOTAL,7980,6739,4136,1058,19913,0,19913
2017,10,España,5114,4783,2445,845,13187,0,13187
2017,10,Holanda,62,36,10,4,112,0,112
2017,10,Bélgica,55,32,39,3,129,0,129
2017,10,Alemania,308,209,89,37,643,0,643
2017,10,Francia,144,202,64,53,463,0,463
2017,10,Reino Unido,599,221,21,9,850,0,850
2017,10,Irlanda,19,64,26,9,118,0,118
2017,10,Italia,176,212,122,87,597,0,597
2017,10,Suecia,210,53,11,0,274,0,274
2017,10,Noruega,156,18,11,4,189,0,189
2017,10,Dinamarca,513,51,6,0,570,0,570
2017,10,Finlandia,98,29,7,3,137,0,137
2017,10,Suiza,88,76,6,8,178,0,178
2017,10,Austria,18,11,9,3,41,0,41
2017,10,Rusia,31,46,34,13,124,0,124
2017,10,Países del Este,77,49,49,18,193,0,193
2017,10,Resto de Europa,134,180,142,53,509,0,509
2017,10,USA,149,63,19,0,231,0,231
2017,10,Resto de América,278,238,93,29,638,0,638
2017,10,Resto del Mundo,506,244,122,25,897,0,897
2017,10,TOTAL,8735,6817,3325,1203,20080,0,20080
2017,11,España,6511,5076,2456,761,14804,0,14804
2017,11,Holanda,77,61,17,15,170,0,170
2017,11,Bélgica,85,46,17,13,161,0,161
2017,11,Alemania,656,379,127,44,1206,0,1206
2017,11,Francia,285,187,124,37,633,0,633
2017,11,Reino Unido,563,234,42,21,860,0,860
2017,11,Irlanda,51,27,6,9,93,0,93
2017,11,Italia,219,261,132,112,724,0,724
2017,11,Suecia,310,78,32,1,421,0,421
2017,11,Noruega,211,39,15,0,265,0,265
2017,11,Dinamarca,156,16,1,0,173,0,173
2017,11,Finlandia,219,91,10,12,332,0,332
2017,11,Suiza,110,30,11,3,154,0,154
2017,11,Austria,60,22,8,5,95,0,95
2017,11,Rusia,61,34,46,12,153,0,153
2017,11,Países del Este,103,73,29,29,234,0,234
2017,11,Resto de Europa,191,250,158,78,677,0,677
2017,11,USA,247,145,22,9,423,0,423
2017,11,Resto de América,221,158,66,34,479,0,479
2017,11,Resto del Mundo,237,347,37,16,637,0,637
2017,11,TOTAL,10573,7554,3356,1211,22694,0,22694
2017,12,España,4990,4330,2356,531,12207,0,12207
2017,12,Holanda,104,74,27,11,216,0,216
2017,12,Bélgica,85,43,26,5,159,0,159
2017,12,Alemania,593,415,186,87,1281,0,1281
2017,12,Francia,155,134,69,24,382,0,382
2017,12,Reino Unido,897,302,27,38,1264,0,1264
2017,12,Irlanda,34,35,30,3,102,0,102
2017,12,Italia,218,296,187,65,766,0,766
2017,12,Suecia,442,64,29,5,540,0,540
2017,12,Noruega,339,61,11,7,418,0,418
2017,12,Dinamarca,140,37,4,4,185,0,185
2017,12,Finlandia,164,77,38,9,288,0,288
2017,12,Suiza,135,56,15,1,207,0,207
2017,12,Austria,39,35,13,0,87,0,87
2017,12,Rusia,66,67,47,8,188,0,188
2017,12,Países del Este,157,81,40,15,293,0,293
2017,12,Resto de Europa,213,121,153,55,542,0,542
2017,12,USA,117,137,22,7,283,0,283
2017,12,Resto de América,222,194,66,30,512,0,512
2017,12,Resto del Mundo,227,352,27,25,631,0,631
2017,12,TOTAL,9337,6911,3373,930,20551,0,20551
2017,13,España,66396,58718,31808,8387,165309,0,165309
2017,13,Holanda,801,601,236,80,1718,0,1718
2017,13,Bélgica,1039,504,251,48,1842,0,1842
2017,13,Alemania,4685,2816,1331,474,9306,0,9306
2017,13,Francia,2494,2160,1204,486,6344,0,6344
2017,13,Reino Unido,7203,2852,569,308,10932,0,10932
2017,13,Irlanda,512,401,167,43,1123,0,1123
2017,13,Italia,2045,3168,1908,845,7966,0,7966
2017,13,Suecia,2517,501,220,39,3277,0,3277
2017,13,Noruega,1803,314,103,33,2253,0,2253
2017,13,Dinamarca,1300,476,49,35,1860,0,1860
2017,13,Finlandia,1256,432,168,68,1924,0,1924
2017,13,Suiza,872,406,108,84,1470,0,1470
2017,13,Austria,326,220,118,36,700,0,700
2017,13,Rusia,644,627,436,134,1841,0,1841
2017,13,Países del Este,1251,672,464,188,2575,0,2575
2017,13,Resto de Europa,2181,2116,1450,708,6455,0,6455
2017,13,USA,1395,1025,297,81,2798,0,2798
2017,13,Resto de América,1646,1893,809,368,4716,0,4716
2017,13,Resto del Mundo,2638,2611,548,254,6051,0,6051
2017,13,TOTAL,103004,82513,42244,12699,240460,0,240460
2018,1,España,4960,4066,2195,542,11763,0,11763
2018,1,Holanda,81,68,19,17,185,0,185
2018,1,Bélgica,73,47,13,3,136,0,136
2018,1,Alemania,682,445,175,62,1364,0,1364
2018,1,Francia,238,130,107,38,513,0,513
2018,1,Reino Unido,709,307,70,32,1118,0,1118
2018,1,Irlanda,67,49,17,8,141,0,141
2018,1,Italia,151,248,126,63,588,0,588
2018,1,Suecia,342,98,22,8,470,0,470
2018,1,Noruega,220,49,28,4,301,0,301
2018,1,Dinamarca,180,89,8,11,288,0,288
2018,1,Finlandia,198,62,29,9,298,0,298
2018,1,Suiza,85,29,13,9,136,0,136
2018,1,Austria,41,18,3,8,70,0,70
2018,1,Rusia,285,65,84,24,458,0,458
2018,1,Países del Este,144,84,44,13,285,0,285
2018,1,Resto de Europa,204,198,132,65,599,0,599
2018,1,USA,101,50,15,3,169,0,169
2018,1,Resto de América,181,144,63,47,435,0,435
2018,1,Resto del Mundo,201,324,18,18,561,0,561
2018,1,TOTAL,9143,6570,3181,984,19878,0,19878
2018,2,España,5652,5124,2659,693,14128,0,14128
2018,2,Holanda,72,69,19,4,164,0,164
2018,2,Bélgica,101,48,16,4,169,0,169
2018,2,Alemania,475,412,157,59,1103,0,1103
2018,2,Francia,301,235,106,32,674,0,674
2018,2,Reino Unido,753,380,40,33,1206,0,1206
2018,2,Irlanda,42,25,22,7,96,0,96
2018,2,Italia,164,257,85,51,557,0,557
2018,2,Suecia,306,110,12,3,431,0,431
2018,2,Noruega,204,42,14,3,263,0,263
2018,2,Dinamarca,146,31,1,13,191,0,191
2018,2,Finlandia,112,42,10,5,169,0,169
2018,2,Suiza,77,34,6,7,124,0,124
2018,2,Austria,30,25,5,13,73,0,73
2018,2,Rusia,60,52,40,5,157,0,157
2018,2,Países del Este,90,86,43,22,241,0,241
2018,2,Resto de Europa,102,175,124,58,459,0,459
2018,2,USA,111,83,26,8,228,0,228
2018,2,Resto de América,158,114,49,28,349,0,349
2018,2,Resto del Mundo,276,338,26,18,658,0,658
2018,2,TOTAL,9232,7682,3460,1066,21440,0,21440
2018,3,España,5591,5038,2448,729,13806,0,13806
2018,3,Holanda,75,60,16,1,152,0,152
2018,3,Bélgica,83,66,10,5,164,0,164
2018,3,Alemania,653,523,167,67,1410,0,1410
2018,3,Francia,211,161,117,50,539,0,539
2018,3,Reino Unido,776,253,33,15,1077,0,1077
2018,3,Irlanda,49,39,10,3,101,0,101
2018,3,Italia,188,213,239,94,734,0,734
2018,3,Suecia,347,60,16,8,431,0,431
2018,3,Noruega,236,44,24,1,305,0,305
2018,3,Dinamarca,173,43,1,3,220,0,220
2018,3,Finlandia,163,43,10,3,219,0,219
2018,3,Suiza,80,54,11,9,154,0,154
2018,3,Austria,39,42,17,0,98,0,98
2018,3,Rusia,42,36,42,13,133,0,133
2018,3,Países del Este,88,81,47,8,224,0,224
2018,3,Resto de Europa,115,142,173,74,504,0,504
2018,3,USA,139,121,21,9,290,0,290
2018,3,Resto de América,247,172,45,32,496,0,496
2018,3,Resto del Mundo,206,328,19,12,565,0,565
2018,3,TOTAL,9501,7519,3466,1136,21622,0,21622
2018,4,España,5588,4774,2360,704,13426,0,13426
2018,4,Holanda,47,20,16,4,87,0,87
2018,4,Bélgica,111,49,15,5,180,0,180
2018,4,Alemania,378,195,66,15,654,0,654
2018,4,Francia,197,153,63,75,488,0,488
2018,4,Reino Unido,429,154,16,11,610,0,610
2018,4,Irlanda,26,20,5,1,52,0,52
2018,4,Italia,110,206,84,58,458,0,458
2018,4,Suecia,209,27,2,1,239,0,239
2018,4,Noruega,132,13,4,1,150,0,150
2018,4,Dinamarca,81,20,0,1,102,0,102
2018,4,Finlandia,97,22,12,4,135,0,135
2018,4,Suiza,85,43,4,11,143,0,143
2018,4,Austria,13,21,6,0,40,0,40
2018,4,Rusia,44,81,63,12,200,0,200
2018,4,Países del Este,60,67,31,5,163,0,163
2018,4,Resto de Europa,144,200,84,51,479,0,479
2018,4,USA,86,59,9,4,158,0,158
2018,4,Resto de América,173,203,59,30,465,0,465
2018,4,Resto del Mundo,190,227,24,20,461,0,461
2018,4,TOTAL,8200,6554,2923,1013,18690,0,18690
2018,5,España,5957,5574,2416,693,14640,0,14640
2018,5,Holanda,27,27,10,9,73,0,73
2018,5,Bélgica,64,29,6,0,99,0,99
2018,5,Alemania,227,122,63,24,436,0,436
2018,5,Francia,133,186,101,54,474,0,474
2018,5,Reino Unido,458,134,13,4,609,0,609
2018,5,Irlanda,18,14,4,1,37,0,37
2018,5,Italia,108,160,126,53,447,0,447
2018,5,Suecia,19,23,4,0,46,0,46
2018,5,Noruega,14,13,8,3,38,0,38
2018,5,Dinamarca,16,7,0,0,23,0,23
2018,5,Finlandia,23,6,5,0,34,0,34
2018,5,Suiza,50,20,2,1,73,0,73
2018,5,Austria,5,13,4,1,23,0,23
2018,5,Rusia,56,27,12,21,116,0,116
2018,5,Países del Este,66,36,9,1,112,0,112
2018,5,Resto de Europa,79,122,27,21,249,0,249
2018,5,USA,69,48,8,8,133,0,133
2018,5,Resto de América,99,159,68,41,367,0,367
2018,5,Resto del Mundo,109,128,18,7,262,0,262
2018,5,TOTAL,7597,6848,2904,942,18291,0,18291
2018,6,España,5576,5687,2526,576,14365,0,14365
2018,6,Holanda,38,17,5,4,64,0,64
2018,6,Bélgica,42,28,5,5,80,0,80
2018,6,Alemania,291,132,44,7,474,0,474
2018,6,Francia,84,94,42,13,233,0,233
2018,6,Reino Unido,743,134,6,5,888,0,888
2018,6,Irlanda,7,14,5,1,27,0,27
2018,6,Italia,84,111,69,44,308,0,308
2018,6,Suecia,23,12,5,3,43,0,43
2018,6,Noruega,20,7,2,3,32,0,32
2018,6,Dinamarca,3,7,0,0,10,0,10
2018,6,Finlandia,4,3,5,0,12,0,12
2018,6,Suiza,24,11,1,0,36,0,36
2018,6,Austria,12,8,5,3,28,0,28
2018,6,Rusia,37,23,18,0,78,0,78
2018,6,Países del Este,63,44,15,8,130,0,130
2018,6,Resto de Europa,86,82,45,13,226,0,226
2018,6,USA,59,123,12,1,195,0,195
2018,6,Resto de América,76,113,66,22,277,0,277
2018,6,Resto del Mundo,97,99,24,9,229,0,229
2018,6,TOTAL,7369,6749,2900,717,17735,0,17735
2018,7,España,4756,5201,1806,720,12483,0,12483
2018,7,Holanda,46,42,3,5,96,0,96
2018,7,Bélgica,78,30,5,0,113,0,113
2018,7,Alemania,265,105,37,15,422,0,422
2018,7,Francia,151,139,32,13,335,0,335
2018,7,Reino Unido,1080,111,4,5,1200,0,1200
2018,7,Irlanda,13,18,4,0,35,0,35
2018,7,Italia,118,204,44,26,392,0,392
2018,7,Suecia,17,12,5,0,34,0,34
2018,7,Noruega,31,13,1,0,45,0,45
2018,7,Dinamarca,11,7,0,0,18,0,18
2018,7,Finlandia,18,10,2,0,30,0,30
2018,7,Suiza,120,13,5,7,145,0,145
2018,7,Austria,17,8,3,0,28,0,28
2018,7,Rusia,67,57,4,3,131,0,131
2018,7,Países del Este,81,30,13,5,129,0,129
2018,7,Resto de Europa,78,291,57,40,466,0,466
2018,7,USA,121,54,4,4,183,0,183
2018,7,Resto de América,145,218,25,46,434,0,434
2018,7,Resto del Mundo,164,157,5,8,334,0,334
2018,7,TOTAL,7377,6720,2059,897,17053,0,17053
2018,8,España,3828,4434,1476,683,10421,0,10421
2018,8,Holanda,63,36,5,5,109,0,109
2018,8,Bélgica,46,29,6,1,82,0,82
2018,8,Alemania,358,159,28,15,560,0,560
2018,8,Francia,311,247,39,26,623,0,623
2018,8,Reino Unido,455,197,6,8,666,0,666
2018,8,Irlanda,5,13,4,4,26,0,26
2018,8,Italia,248,439,171,59,917,0,917
2018,8,Suecia,13,21,5,1,40,0,40
2018,8,Noruega,29,8,0,0,37,0,37
2018,8,Dinamarca,13,23,1,0,37,0,37
2018,8,Finlandia,0,0,0,0,0,0,0
2018,8,Suiza,37,18,1,0,56,0,56
2018,8,Austria,13,19,3,3,38,0,38
2018,8,Rusia,48,68,8,3,127,0,127
2018,8,Países del Este,89,21,13,13,136,0,136
2018,8,Resto de Europa,103,204,21,11,339,0,339
2018,8,USA,47,25,4,1,77,0,77
2018,8,Resto de América,67,160,18,37,282,0,282
2018,8,Resto del Mundo,174,130,6,13,323,0,323
2018,8,TOTAL,5947,6251,1815,883,14896,0,14896
2018,9,España,4323,4138,2604,635,11700,0,11700
2018,9,Holanda,35,25,14,11,85,0,85
2018,9,Bélgica,52,25,14,7,98,0,98
2018,9,Alemania,397,163,53,8,621,0,621
2018,9,Francia,221,146,70,33,470,0,470
2018,9,Reino Unido,329,140,20,8,497,0,497
2018,9,Irlanda,20,23,16,4,63,0,63
2018,9,Italia,124,128,83,40,375,0,375
2018,9,Suecia,31,14,8,1,54,0,54
2018,9,Noruega,33,7,0,0,40,0,40
2018,9,Dinamarca,25,3,0,0,28,0,28
2018,9,Finlandia,20,6,9,3,38,0,38
2018,9,Suiza,109,19,9,0,137,0,137
2018,9,Austria,17,17,13,4,51,0,51
2018,9,Rusia,46,25,14,7,92,0,92
2018,9,Países del Este,72,68,9,16,165,0,165
2018,9,Resto de Europa,79,191,74,16,360,0,360
2018,9,USA,181,64,33,7,285,0,285
2018,9,Resto de América,98,135,45,15,293,0,293
2018,9,Resto del Mundo,205,237,58,16,516,0,516
2018,9,TOTAL,6417,5574,3146,831,15968,0,15968
2018,10,España,5274,5030,2197,689,13190,0,13190
2018,10,Holanda,65,46,3,0,114,0,114
2018,10,Bélgica,176,24,5,4,209,0,209
2018,10,Alemania,545,161,67,29,802,0,802
2018,10,Francia,224,172,68,22,486,0,486
2018,10,Reino Unido,721,289,17,8,1035,0,1035
2018,10,Irlanda,44,21,6,3,74,0,74
2018,10,Italia,173,164,98,51,486,0,486
2018,10,Suecia,228,46,12,1,287,0,287
2018,10,Noruega,161,19,3,0,183,0,183
2018,10,Dinamarca,102,22,2,0,126,0,126
2018,10,Finlandia,220,16,6,11,253,0,253
2018,10,Suiza,113,37,3,1,154,0,154
2018,10,Austria,23,24,6,3,56,0,56
2018,10,Rusia,60,40,30,15,145,0,145
2018,10,Países del Este,131,34,19,9,193,0,193
2018,10,Resto de Europa,115,217,83,26,441,0,441
2018,10,USA,142,45,11,4,202,0,202
2018,10,Resto de América,104,167,67,33,371,0,371
2018,10,Resto del Mundo,131,166,49,5,351,0,351
2018,10,TOTAL,8752,6740,2752,914,19158,0,19158
2018,11,España,6224,5053,2719,717,14713,0,14713
2018,11,Holanda,83,33,16,20,152,0,152
2018,11,Bélgica,80,51,12,7,150,0,150
2018,11,Alemania,485,305,140,34,964,0,964
2018,11,Francia,190,187,70,47,494,0,494
2018,11,Reino Unido,496,329,17,12,854,0,854
2018,11,Irlanda,56,29,14,1,100,0,100
2018,11,Italia,205,174,136,51,566,0,566
2018,11,Suecia,366,74,24,9,473,0,473
2018,11,Noruega,180,21,12,0,213,0,213
2018,11,Dinamarca,251,92,0,0,343,0,343
2018,11,Finlandia,174,41,12,4,231,0,231
2018,11,Suiza,74,36,6,1,117,0,117
2018,11,Austria,33,31,9,0,73,0,73
2018,11,Rusia,46,32,25,13,116,0,116
2018,11,Países del Este,92,52,24,3,171,0,171
2018,11,Resto de Europa,180,297,161,37,675,0,675
2018,11,USA,129,82,13,5,229,0,229
2018,11,Resto de América,208,140,67,50,465,0,465
2018,11,Resto del Mundo,255,198,24,26,503,0,503
2018,11,TOTAL,9807,7257,3501,1037,21602,0,21602
2018,12,España,4862,4720,2572,720,12874,0,12874
2018,12,Holanda,83,63,36,9,191,0,191
2018,12,Bélgica,85,53,19,15,172,0,172
2018,12,Alemania,696,407,231,59,1393,0,1393
2018,12,Francia,242,180,87,32,541,0,541
2018,12,Reino Unido,627,323,42,29,1021,0,1021
2018,12,Irlanda,51,54,19,4,128,0,128
2018,12,Italia,206,277,133,62,678,0,678
2018,12,Suecia,376,65,25,8,474,0,474
2018,12,Noruega,211,36,31,4,282,0,282
2018,12,Dinamarca,223,32,4,5,264,0,264
2018,12,Finlandia,218,77,32,11,338,0,338
2018,12,Suiza,100,40,6,3,149,0,149
2018,12,Austria,77,36,15,4,132,0,132
2018,12,Rusia,89,113,54,12,268,0,268
2018,12,Países del Este,115,54,43,13,225,0,225
2018,12,Resto de Europa,157,234,140,49,580,0,580
2018,12,USA,109,85,11,3,208,0,208
2018,12,Resto de América,116,162,58,28,364,0,364
2018,12,Resto del Mundo,219,222,46,24,511,0,511
2018,12,TOTAL,8862,7233,3604,1094,20793,0,20793
2018,13,España,62591,58839,27978,8101,157509,0,157509
2018,13,Holanda,715,506,162,89,1472,0,1472
2018,13,Bélgica,991,479,126,56,1652,0,1652
2018,13,Alemania,5452,3129,1228,394,10203,0,10203
2018,13,Francia,2503,2030,902,435,5870,0,5870
2018,13,Reino Unido,7576,2751,284,170,10781,0,10781
2018,13,Irlanda,398,319,126,37,880,0,880
2018,13,Italia,1879,2581,1394,652,6506,0,6506
2018,13,Suecia,2277,562,140,43,3022,0,3022
2018,13,Noruega,1471,272,127,19,1889,0,1889
2018,13,Dinamarca,1224,376,17,33,1650,0,1650
2018,13,Finlandia,1247,328,132,50,1757,0,1757
2018,13,Suiza,954,354,67,49,1424,0,1424
2018,13,Austria,320,262,89,39,710,0,710
2018,13,Rusia,880,619,394,128,2021,0,2021
2018,13,Países del Este,1091,657,310,116,2174,0,2174
2018,13,Resto de Europa,1442,2353,1121,461,5377,0,5377
2018,13,USA,1294,839,167,57,2357,0,2357
2018,13,Resto de América,1672,1887,630,409,4598,0,4598
2018,13,Resto del Mundo,2227,2554,317,176,5274,0,5274
2018,13,TOTAL,98204,81697,35711,11514,227126,0,227126
2019,1,España,4578,4485,2664,601,12328,0,12328
2019,1,Holanda,93,99,32,15,239,0,239
2019,1,Bélgica,53,42,43,4,142,0,142
2019,1,Alemania,772,388,206,86,1452,0,1452
2019,1,Francia,268,204,112,28,612,0,612
2019,1,Reino Unido,749,392,33,22,1196,0,1196
2019,1,Irlanda,64,69,11,17,161,0,161
2019,1,Italia,250,259,136,50,695,0,695
2019,1,Suecia,312,68,36,9,425,0,425
2019,1,Noruega,176,30,16,3,225,0,225
2019,1,Dinamarca,182,55,6,9,252,0,252
2019,1,Finlandia,168,76,18,4,266,0,266
2019,1,Suiza,110,28,4,4,146,0,146
2019,1,Austria,53,36,11,1,101,0,101
2019,1,Rusia,119,121,91,124,455,0,455
2019,1,Países del Este,159,69,31,30,289,0,289
2019,1,Resto de Europa,242,237,133,53,665,0,665
2019,1,USA,120,74,8,1,203,0,203
2019,1,Resto de América,174,174,111,40,499,0,499
2019,1,Resto del Mundo,163,279,23,21,486,0,486
2019,1,TOTAL,8805,7185,3725,1122,20837,0,20837
2019,2,España,5128,5281,2561,629,13599,0,13599
2019,2,Holanda,78,57,18,4,157,0,157
2019,2,Bélgica,60,36,17,5,118,0,118
2019,2,Alemania,498,350,151,40,1039,0,1039
2019,2,Francia,307,195,137,44,683,0,683
2019,2,Reino Unido,766,340,33,3,1142,0,1142
2019,2,Irlanda,51,44,19,4,118,0,118
2019,2,Italia,215,254,154,38,661,0,661
2019,2,Suecia,289,40,23,6,358,0,358
2019,2,Noruega,208,23,11,0,242,0,242
2019,2,Dinamarca,150,36,3,2,191,0,191
2019,2,Finlandia,137,40,30,3,210,0,210
2019,2,Suiza,81,46,10,3,140,0,140
2019,2,Austria,44,29,17,3,93,0,93
2019,2,Rusia,151,58,50,24,283,0,283
2019,2,Países del Este,134,65,33,4,236,0,236
2019,2,Resto de Europa,179,233,148,56,616,0,616
2019,2,USA,181,62,15,0,258,0,258
2019,2,Resto de América,140,109,92,34,375,0,375
2019,2,Resto del Mundo,243,277,31,13,564,0,564
2019,2,TOTAL,9040,7575,3553,915,21083,0,21083
2019,3,España,5861,6189,2713,778,15541,0,15541
2019,3,Holanda,100,52,30,6,188,0,188
2019,3,Bélgica,90,33,5,4,132,0,132
2019,3,Alemania,538,355,200,72,1165,0,1165
2019,3,Francia,268,174,86,31,559,0,559
2019,3,Reino Unido,631,367,32,17,1047,0,1047
2019,3,Irlanda,53,26,25,3,107,0,107
2019,3,Italia,246,255,134,39,674,0,674
2019,3,Suecia,345,57,37,4,443,0,443
2019,3,Noruega,213,8,18,2,241,0,241
2019,3,Dinamarca,178,89,0,1,268,0,268
2019,3,Finlandia,179,36,10,1,226,0,226
2019,3,Suiza,108,42,1,5,156,0,156
2019,3,Austria,48,20,4,4,76,0,76
2019,3,Rusia,86,102,52,11,251,0,251
2019,3,Países del Este,113,76,42,11,242,0,242
2019,3,Resto de Europa,179,187,96,30,492,0,492
2019,3,USA,138,97,12,6,253,0,253
2019,3,Resto de América,154,183,89,24,450,0,450
2019,3,Resto del Mundo,336,279,28,15,658,0,658
2019,3,TOTAL,9864,8627,3614,1064,23169,0,23169
2019,4,España,4654,4585,2005,668,11912,0,11912
2019,4,Holanda,33,43,5,3,84,0,84
2019,4,Bélgica,49,44,18,1,112,0,112
2019,4,Alemania,348,260,106,46,760,0,760
2019,4,Francia,226,123,63,10,422,0,422
2019,4,Reino Unido,403,214,8,6,631,0,631
2019,4,Irlanda,21,27,17,0,65,0,65
2019,4,Italia,163,180,120,40,503,0,503
2019,4,Suecia,230,6,5,0,241,0,241
2019,4,Noruega,155,12,0,2,169,0,169
2019,4,Dinamarca,136,29,5,0,170,0,170
2019,4,Finlandia,104,19,3,0,126,0,126
2019,4,Suiza,89,27,1,28,145,0,145
2019,4,Austria,16,34,2,0,52,0,52
2019,4,Rusia,58,78,30,15,181,0,181
2019,4,Países del Este,120,54,19,6,199,0,199
2019,4,Resto de Europa,159,198,84,16,457,0,457
2019,4,USA,112,47,6,5,170,0,170
2019,4,Resto de América,126,135,54,29,344,0,344
2019,4,Resto del Mundo,241,364,29,15,649,0,649
2019,4,TOTAL,7443,6479,2580,890,17392,0,17392
2019,5,España,5248,5445,2327,690,13710,0,13710
2019,5,Holanda,20,56,17,3,96,0,96
2019,5,Bélgica,63,33,22,3,121,0,121
2019,5,Alemania,220,98,37,13,368,0,368
2019,5,Francia,290,179,73,38,580,0,580
2019,5,Reino Unido,455,111,8,8,582,0,582
2019,5,Irlanda,29,14,6,3,52,0,52
2019,5,Italia,142,153,64,31,390,0,390
2019,5,Suecia,15,9,0,2,26,0,26
2019,5,Noruega,9,4,1,0,14,0,14
2019,5,Dinamarca,15,4,1,0,20,0,20
2019,5,Finlandia,30,7,1,0,38,0,38
2019,5,Suiza,59,27,3,4,93,0,93
2019,5,Austria,13,20,4,0,37,0,37
2019,5,Rusia,38,44,18,16,116,0,116
2019,5,Países del Este,100,26,23,2,151,0,151
2019,5,Resto de Europa,84,112,50,23,269,0,269
2019,5,USA,84,86,12,2,184,0,184
2019,5,Resto de América,81,167,71,31,350,0,350
2019,5,Resto del Mundo,78,209,16,15,318,0,318
2019,5,TOTAL,7073,6804,2754,884,17515,0,17515
2019,6,España,4904,5277,1816,699,12696,0,12696
2019,6,Holanda,32,38,5,0,75,0,75
2019,6,Bélgica,44,22,17,12,95,0,95
2019,6,Alemania,139,88,32,26,285,0,285
2019,6,Francia,129,92,68,15,304,0,304
2019,6,Reino Unido,349,113,3,7,472,0,472
2019,6,Irlanda,5,20,4,0,29,0,29
2019,6,Italia,123,129,40,33,325,0,325
2019,6,Suecia,20,11,2,0,33,0,33
2019,6,Noruega,5,3,2,0,10,0,10
2019,6,Dinamarca,11,3,0,0,14,0,14
2019,6,Finlandia,10,5,1,0,16,0,16
2019,6,Suiza,48,3,1,0,52,0,52
2019,6,Austria,11,21,5,1,38,0,38
2019,6,Rusia,26,9,5,1,41,0,41
2019,6,Países del Este,65,15,16,3,99,0,99
2019,6,Resto de Europa,97,110,66,18,291,0,291
2019,6,USA,79,81,8,8,176,0,176
2019,6,Resto de América,84,135,78,34,331,0,331
2019,6,Resto del Mundo,76,114,12,7,209,0,209
2019,6,TOTAL,6257,6289,2181,864,15591,0,15591
2019,7,España,5089,5761,2699,863,14412,0,14412
2019,7,Holanda,43,37,3,7,90,0,90
2019,7,Bélgica,43,23,13,0,79,0,79
2019,7,Alemania,234,66,47,11,358,0,358
2019,7,Francia,223,112,50,11,396,0,396
2019,7,Reino Unido,458,148,19,7,632,0,632
2019,7,Irlanda,39,10,8,0,57,0,57
2019,7,Italia,167,205,56,32,460,0,460
2019,7,Suecia,25,20,9,0,54,0,54
2019,7,Noruega,26,12,2,1,41,0,41
2019,7,Dinamarca,11,16,0,0,27,0,27
2019,7,Finlandia,6,1,0,0,7,0,7
2019,7,Suiza,53,9,3,0,65,0,65
2019,7,Austria,60,14,3,3,80,0,80
2019,7,Rusia,37,70,64,6,177,0,177
2019,7,Países del Este,152,28,28,0,208,0,208
2019,7,Resto de Europa,99,190,41,47,377,0,377
2019,7,USA,111,61,3,4,179,0,179
2019,7,Resto de América,131,243,58,49,481,0,481
2019,7,Resto del Mundo,136,169,27,22,354,0,354
2019,7,TOTAL,7143,7195,3133,1063,18534,0,18534
2019,8,España,4360,4343,2143,797,11643,0,11643
2019,8,Holanda,58,40,9,1,108,0,108
2019,8,Bélgica,41,28,6,1,76,0,76
2019,8,Alemania,238,80,44,8,370,0,370
2019,8,Francia,313,191,66,24,594,0,594
2019,8,Reino Unido,337,148,8,1,494,0,494
2019,8,Irlanda,18,13,6,0,37,0,37
2019,8,Italia,219,325,147,52,743,0,743
2019,8,Suecia,17,12,6,0,35,0,35
2019,8,Noruega,20,8,8,0,36,0,36
2019,8,Dinamarca,29,7,0,0,36,0,36
2019,8,Finlandia,3,3,2,1,9,0,9
2019,8,Suiza,18,10,0,6,34,0,34
2019,8,Austria,14,5,2,3,24,0,24
2019,8,Rusia,82,47,9,6,144,0,144
2019,8,Países del Este,125,35,61,3,224,0,224
2019,8,Resto de Europa,100,128,33,22,283,0,283
2019,8,USA,88,49,20,8,165,0,165
2019,8,Resto de América,90,185,58,28,361,0,361
2019,8,Resto del Mundo,168,152,27,10,357,0,357
2019,8,TOTAL,6338,5809,2655,971,15773,0,15773
2019,9,España,4960,4844,2434,714,12952,0,12952
2019,9,Holanda,53,37,15,1,106,0,106
2019,9,Bélgica,60,36,8,3,107,0,107
2019,9,Alemania,226,101,40,11,378,0,378
2019,9,Francia,215,144,81,15,455,0,455
2019,9,Reino Unido,755,151,12,3,921,0,921
2019,9,Irlanda,14,35,8,0,57,0,57
2019,9,Italia,148,167,101,33,449,0,449
2019,9,Suecia,26,8,4,0,38,0,38
2019,9,Noruega,68,27,0,0,95,0,95
2019,9,Dinamarca,27,19,1,0,47,0,47
2019,9,Finlandia,17,7,0,0,24,0,24
2019,9,Suiza,55,9,5,1,70,0,70
2019,9,Austria,14,7,9,0,30,0,30
2019,9,Rusia,53,27,25,8,113,0,113
2019,9,Países del Este,76,34,39,2,151,0,151
2019,9,Resto de Europa,88,171,39,36,334,0,334
2019,9,USA,100,54,10,1,165,0,165
2019,9,Resto de América,94,244,130,33,501,0,501
2019,9,Resto del Mundo,127,126,79,19,351,0,351
2019,9,TOTAL,7176,6248,3040,880,17344,0,17344
2019,10,España,5453,5357,2641,690,14141,0,14141
2019,10,Holanda,50,41,10,5,106,0,106
2019,10,Bélgica,53,33,10,0,96,0,96
2019,10,Alemania,459,178,68,18,723,0,723
2019,10,Francia,282,146,82,26,536,0,536
2019,10,Reino Unido,401,161,21,5,588,0,588
2019,10,Irlanda,22,27,13,0,62,0,62
2019,10,Italia,150,190,106,42,488,0,488
2019,10,Suecia,221,14,18,0,253,0,253
2019,10,Noruega,149,45,8,2,204,0,204
2019,10,Dinamarca,80,6,2,1,89,0,89
2019,10,Finlandia,118,13,16,0,147,0,147
2019,10,Suiza,95,31,2,3,131,0,131
2019,10,Austria,28,7,2,0,37,0,37
2019,10,Rusia,60,24,15,11,110,0,110
2019,10,Países del Este,121,42,33,4,200,0,200
2019,10,Resto de Europa,150,160,73,38,421,0,421
2019,10,USA,85,56,16,9,166,0,166
2019,10,Resto de América,105,176,95,29,405,0,405
2019,10,Resto del Mundo,174,119,37,19,349,0,349
2019,10,TOTAL,8256,6826,3268,902,19252,0,19252
2019,11,España,6316,5935,3322,970,16543,0,16543
2019,11,Holanda,68,51,19,7,145,0,145
2019,11,Bélgica,94,49,18,6,167,0,167
2019,11,Alemania,600,319,149,32,1100,0,1100
2019,11,Francia,317,169,163,21,670,0,670
2019,11,Reino Unido,612,277,54,28,971,0,971
2019,11,Irlanda,52,38,10,3,103,0,103
2019,11,Italia,259,200,144,46,649,0,649
2019,11,Suecia,301,39,29,0,369,0,369
2019,11,Noruega,185,66,23,1,275,0,275
2019,11,Dinamarca,149,16,3,4,172,0,172
2019,11,Finlandia,173,68,22,0,263,0,263
2019,11,Suiza,116,49,12,4,181,0,181
2019,11,Austria,51,30,8,0,89,0,89
2019,11,Rusia,36,58,46,11,151,0,151
2019,11,Países del Este,134,64,89,8,295,0,295
2019,11,Resto de Europa,245,225,94,32,596,0,596
2019,11,USA,137,67,17,3,224,0,224
2019,11,Resto de América,157,208,127,39,531,0,531
2019,11,Resto del Mundo,228,286,37,10,561,0,561
2019,11,TOTAL,10230,8214,4386,1225,24055,0,24055
2019,12,España,5023,5392,2980,765,14160,0,14160
2019,12,Holanda,243,81,27,7,358,0,358
2019,12,Bélgica,83,52,29,8,172,0,172
2019,12,Alemania,620,353,216,50,1239,0,1239
2019,12,Francia,281,192,137,21,631,0,631
2019,12,Reino Unido,619,285,53,54,1011,0,1011
2019,12,Irlanda,41,43,13,1,98,0,98
2019,12,Italia,196,190,172,41,599,0,599
2019,12,Suecia,286,37,47,14,384,0,384
2019,12,Noruega,169,63,25,7,264,0,264
2019,12,Dinamarca,160,31,2,1,194,0,194
2019,12,Finlandia,181,72,51,0,304,0,304
2019,12,Suiza,110,54,15,6,185,0,185
2019,12,Austria,75,38,12,4,129,0,129
2019,12,Rusia,80,98,92,17,287,0,287
2019,12,Países del Este,107,71,80,7,265,0,265
2019,12,Resto de Europa,224,195,81,49,549,0,549
2019,12,USA,162,80,23,6,271,0,271
2019,12,Resto de América,118,185,122,67,492,0,492
2019,12,Resto del Mundo,286,281,55,3,625,0,625
2019,12,TOTAL,9064,7793,4232,1128,22217,0,22217
2019,13,España,61574,62894,30305,8864,163637,0,163637
2019,13,Holanda,871,632,190,59,1752,0,1752
2019,13,Bélgica,733,431,206,47,1417,0,1417
2019,13,Alemania,4892,2636,1296,413,9237,0,9237
2019,13,Francia,3119,1921,1118,284,6442,0,6442
2019,13,Reino Unido,6535,2707,284,161,9687,0,9687
2019,13,Irlanda,409,366,140,31,946,0,946
2019,13,Italia,2278,2507,1374,477,6636,0,6636
2019,13,Suecia,2087,321,216,35,2659,0,2659
2019,13,Noruega,1383,301,114,18,1816,0,1816
2019,13,Dinamarca,1128,311,23,18,1480,0,1480
2019,13,Finlandia,1126,347,154,9,1636,0,1636
2019,13,Suiza,942,335,57,64,1398,0,1398
2019,13,Austria,427,261,79,19,786,0,786
2019,13,Rusia,826,736,497,250,2309,0,2309
2019,13,Países del Este,1406,579,494,80,2559,0,2559
2019,13,Resto de Europa,1846,2146,938,420,5350,0,5350
2019,13,USA,1397,814,150,53,2414,0,2414
2019,13,Resto de América,1454,2144,1085,437,5120,0,5120
2019,13,Resto del Mundo,2256,2655,401,169,5481,0,5481
2019,13,TOTAL,96689,85044,39121,11908,232762,0,232762
2020,1,España,4811,4713,2825,756,13105,0,13105
2020,1,Holanda,84,77,29,11,201,0,201
2020,1,Bélgica,115,52,29,3,199,0,199
2020,1,Alemania,719,304,186,47,1256,0,1256
2020,1,Francia,283,217,151,18,669,0,669
2020,1,Gran Bretaña,732,398,65,15,1210,0,1210
2020,1,Irlanda,78,60,19,4,161,0,161
2020,1,Italia,190,283,151,31,655,0,655
2020,1,Suecia,305,41,40,4,390,0,390
2020,1,Noruega,154,91,11,1,257,0,257
2020,1,Dinamarca,220,54,19,4,297,0,297
2020,1,Finlandia,195,61,40,4,300,0,300
2020,1,Suiza,104,48,18,4,174,0,174
2020,1,Austria,61,38,12,8,119,0,119
2020,1,Rusia,150,114,64,27,355,0,355
2020,1,Países del Este,159,110,151,4,424,0,424
2020,1,Resto de Europa,186,283,112,45,626,0,626
2020,1,Estados Unidos,109,70,24,1,204,0,204
2020,1,Resto de América,172,151,132,43,498,0,498
2020,1,Resto del Mundo,262,391,59,22,734,0,734
2020,1,TOTAL,9089,7556,4137,1052,21834,0,21834
2020,2,España,6032,6013,3236,760,16041,0,16041
2020,2,Holanda,89,69,16,7,181,0,181
2020,2,Bélgica,69,22,32,6,129,0,129
2020,2,Alemania,565,286,124,52,1027,0,1027
2020,2,Francia,408,216,150,36,810,0,810
2020,2,Gran Bretaña,588,274,82,25,969,0,969
2020,2,Irlanda,75,61,18,4,158,0,158
2020,2,Italia,233,313,147,34,727,0,727
2020,2,Suecia,328,40,26,1,395,0,395
2020,2,Noruega,163,21,4,0,188,0,188
2020,2,Dinamarca,145,47,6,6,204,0,204
2020,2,Finlandia,159,32,9,6,206,0,206
2020,2,Suiza,117,47,9,6,179,0,179
2020,2,Austria,64,15,8,1,88,0,88
2020,2,Rusia,77,51,52,0,180,0,180
2020,2,Países del Este,176,42,73,18,309,0,309
2020,2,Resto de Europa,190,188,70,41,489,0,489
2020,2,Estados Unidos,166,100,29,22,317,0,317
2020,2,Resto de América,172,150,85,38,445,0,445
2020,2,Resto del Mundo,397,134,27,1,559,0,559
2020,2,TOTAL,10213,8121,4203,1064,23601,0,23601
2020,3,España,2258,2236,1114,224,5832,0,5832
2020,3,Holanda,37,12,11,0,60,0,60
2020,3,Bélgica,59,0,3,4,66,0,66
2020,3,Alemania,214,108,80,13,415,0,415
2020,3,Francia,239,81,35,7,362,0,362
2020,3,Gran Bretaña,191,65,11,4,271,0,271
2020,3,Irlanda,18,19,11,0,48,0,48
2020,3,Italia,49,48,33,6,136,0,136
2020,3,Suecia,153,8,13,1,175,0,175
2020,3,Noruega,98,6,6,0,110,0,110
2020,3,Dinamarca,78,2,0,0,80,0,80
2020,3,Finlandia,73,8,8,1,90,0,90
2020,3,Suiza,23,29,3,0,55,0,55
2020,3,Austria,24,0,0,0,24,0,24
2020,3,Rusia,32,4,32,0,68,0,68
2020,3,Países del Este,72,0,18,11,101,0,101
2020,3,Resto de Europa,69,189,30,4,292,0,292
2020,3,Estados Unidos,26,4,15,0,45,0,45
2020,3,Resto de América,58,29,37,21,145,0,145
2020,3,Resto del Mundo,95,23,16,4,138,0,138
2020,3,TOTAL,3866,2871,1476,300,8513,0,8513
